instant,dteday,season,yr,mnth,holiday,weekday,workingday,weathersit,temp_daily,atemp,hum_daily,windspeed_daily,casual,registered,cnt_daily,cnt_hourly,temp_hourly,hum_hourly,windspeed_hourly
1,2011-01-01,1,0,1,0,6,0,2,0.344167,0.363625,0.805833,0.160446,331,654,985,985,0.3441666666666667,0.8058333333333333,0.16044583333333332
2,2011-01-02,1,0,1,0,0,0,2,0.363478,0.353739,0.696087,0.248539,131,670,801,801,0.3634782608695652,0.696086956521739,0.24853913043478262
3,2011-01-03,1,0,1,0,1,1,1,0.196364,0.189405,0.437273,0.248309,120,1229,1349,1349,0.19636363636363638,0.43727272727272726,0.2483090909090909
4,2011-01-04,1,0,1,0,2,1,1,0.2,0.212122,0.590435,0.160296,108,1454,1562,1562,0.19999999999999998,0.5904347826086956,0.16029565217391303
5,2011-01-05,1,0,1,0,3,1,1,0.226957,0.22927,0.436957,0.1869,82,1518,1600,1600,0.22695652173913042,0.43695652173913047,0.1869
6,2011-01-06,1,0,1,0,4,1,1,0.204348,0.233209,0.518261,0.0895652,88,1518,1606,1606,0.20434782608695654,0.5182608695652174,0.08956521739130435
7,2011-01-07,1,0,1,0,5,1,2,0.196522,0.208839,0.498696,0.168726,148,1362,1510,1510,0.1965217391304348,0.498695652173913,0.16872608695652175
8,2011-01-08,1,0,1,0,6,0,2,0.165,0.162254,0.535833,0.266804,68,891,959,959,0.165,0.5358333333333333,0.2668041666666667
9,2011-01-09,1,0,1,0,0,0,1,0.138333,0.116175,0.434167,0.36195,54,768,822,822,0.13833333333333334,0.43416666666666665,0.36195
10,2011-01-10,1,0,1,0,1,1,1,0.150833,0.150888,0.482917,0.223267,41,1280,1321,1321,0.15083333333333335,0.48291666666666666,0.2232666666666667
11,2011-01-11,1,0,1,0,2,1,2,0.169091,0.191464,0.686364,0.122132,43,1220,1263,1263,0.1690909090909091,0.6863636363636364,0.12213181818181819
12,2011-01-12,1,0,1,0,3,1,1,0.172727,0.160473,0.599545,0.304627,25,1137,1162,1162,0.17272727272727273,0.5995454545454545,0.30462727272727275
13,2011-01-13,1,0,1,0,4,1,1,0.165,0.150883,0.470417,0.301,38,1368,1406,1406,0.165,0.47041666666666665,0.301
14,2011-01-14,1,0,1,0,5,1,1,0.16087,0.188413,0.537826,0.126548,54,1367,1421,1421,0.16086956521739132,0.5378260869565217,0.12654782608695653
15,2011-01-15,1,0,1,0,6,0,2,0.233333,0.248112,0.49875,0.157963,222,1026,1248,1248,0.2333333333333333,0.49875,0.1579625
16,2011-01-16,1,0,1,0,0,0,1,0.231667,0.234217,0.48375,0.188433,251,953,1204,1204,0.2316666666666667,0.48374999999999996,0.18843333333333334
17,2011-01-17,1,0,1,1,1,0,2,0.175833,0.176771,0.5375,0.194017,117,883,1000,1000,0.1758333333333333,0.5375,0.19401666666666664
18,2011-01-18,1,0,1,0,2,1,2,0.216667,0.232333,0.861667,0.146775,9,674,683,683,0.21666666666666667,0.8616666666666667,0.14677500000000002
19,2011-01-19,1,0,1,0,3,1,2,0.292174,0.298422,0.741739,0.208317,78,1572,1650,1650,0.29217391304347823,0.7417391304347826,0.20831739130434782
20,2011-01-20,1,0,1,0,4,1,2,0.261667,0.25505,0.538333,0.195904,83,1844,1927,1927,0.26166666666666666,0.5383333333333333,0.19590416666666666
21,2011-01-21,1,0,1,0,5,1,1,0.1775,0.157833,0.457083,0.353242,75,1468,1543,1543,0.1775,0.45708333333333334,0.3532416666666667
22,2011-01-22,1,0,1,0,6,0,1,0.0591304,0.0790696,0.4,0.17197,93,888,981,981,0.0591304347826087,0.39999999999999997,0.1719695652173913
23,2011-01-23,1,0,1,0,0,0,1,0.0965217,0.0988391,0.436522,0.2466,150,836,986,986,0.0965217391304348,0.43652173913043474,0.2466
24,2011-01-24,1,0,1,0,1,1,1,0.0973913,0.11793,0.491739,0.15833,86,1330,1416,1416,0.0973913043478261,0.4917391304347826,0.1583304347826087
25,2011-01-25,1,0,1,0,2,1,2,0.223478,0.234526,0.616957,0.129796,186,1799,1985,1985,0.2234782608695652,0.6169565217391304,0.12979565217391303
26,2011-01-26,1,0,1,0,3,1,3,0.2175,0.2036,0.8625,0.29385,34,472,506,506,0.2175,0.8625,0.29385
27,2011-01-27,1,0,1,0,4,1,1,0.195,0.2197,0.6875,0.113837,15,416,431,431,0.195,0.6875,0.11383750000000001
28,2011-01-28,1,0,1,0,5,1,2,0.203478,0.223317,0.793043,0.1233,38,1129,1167,1167,0.2034782608695652,0.7930434782608696,0.1233
29,2011-01-29,1,0,1,0,6,0,1,0.196522,0.212126,0.651739,0.145365,123,975,1098,1098,0.19652173913043477,0.6517391304347826,0.14536521739130434
30,2011-01-30,1,0,1,0,0,0,1,0.216522,0.250322,0.722174,0.0739826,140,956,1096,1096,0.2165217391304348,0.7221739130434782,0.07398260869565218
31,2011-01-31,1,0,1,0,1,1,2,0.180833,0.18625,0.60375,0.187192,42,1459,1501,1501,0.18083333333333332,0.60375,0.18719166666666667
32,2011-02-01,1,0,2,0,2,1,2,0.192174,0.23453,0.829565,0.053213,47,1313,1360,1360,0.19217391304347825,0.8295652173913044,0.05321304347826087
33,2011-02-02,1,0,2,0,3,1,2,0.26,0.254417,0.775417,0.264308,72,1454,1526,1526,0.26,0.7754166666666666,0.2643083333333333
34,2011-02-03,1,0,2,0,4,1,1,0.186957,0.177878,0.437826,0.277752,61,1489,1550,1550,0.18695652173913044,0.43782608695652175,0.27775217391304347
35,2011-02-04,1,0,2,0,5,1,2,0.211304,0.228587,0.585217,0.127839,88,1620,1708,1708,0.21130434782608698,0.5852173913043479,0.12783913043478262
36,2011-02-05,1,0,2,0,6,0,2,0.233333,0.243058,0.929167,0.161079,100,905,1005,1005,0.2333333333333333,0.9291666666666667,0.16107916666666666
37,2011-02-06,1,0,2,0,0,0,1,0.285833,0.291671,0.568333,0.1418,354,1269,1623,1623,0.28583333333333333,0.5683333333333334,0.1418
38,2011-02-07,1,0,2,0,1,1,1,0.271667,0.303658,0.738333,0.0454083,120,1592,1712,1712,0.27166666666666667,0.7383333333333333,0.045408333333333335
39,2011-02-08,1,0,2,0,2,1,1,0.220833,0.198246,0.537917,0.36195,64,1466,1530,1530,0.22083333333333333,0.5379166666666667,0.36195
40,2011-02-09,1,0,2,0,3,1,2,0.134783,0.144283,0.494783,0.188839,53,1552,1605,1605,0.13478260869565217,0.4947826086956522,0.18883913043478262
41,2011-02-10,1,0,2,0,4,1,1,0.144348,0.149548,0.437391,0.221935,47,1491,1538,1538,0.14434782608695654,0.4373913043478261,0.22193478260869565
42,2011-02-11,1,0,2,0,5,1,1,0.189091,0.213509,0.506364,0.10855,149,1597,1746,1746,0.1890909090909091,0.5063636363636363,0.10855000000000001
43,2011-02-12,1,0,2,0,6,0,1,0.2225,0.232954,0.544167,0.203367,288,1184,1472,1472,0.2225,0.5441666666666667,0.20336666666666667
44,2011-02-13,1,0,2,0,0,0,1,0.316522,0.324113,0.457391,0.260883,397,1192,1589,1589,0.3165217391304348,0.45739130434782604,0.26088260869565216
45,2011-02-14,1,0,2,0,1,1,1,0.415,0.39835,0.375833,0.417908,208,1705,1913,1913,0.41500000000000004,0.3758333333333333,0.4179083333333333
46,2011-02-15,1,0,2,0,2,1,1,0.266087,0.254274,0.314348,0.291374,140,1675,1815,1815,0.26608695652173914,0.31434782608695655,0.29137391304347826
47,2011-02-16,1,0,2,0,3,1,1,0.318261,0.3162,0.423478,0.251791,218,1897,2115,2115,0.31826086956521743,0.42347826086956525,0.2517913043478261
48,2011-02-17,1,0,2,0,4,1,1,0.435833,0.428658,0.505,0.230104,259,2216,2475,2475,0.43583333333333335,0.505,0.23010416666666667
49,2011-02-18,1,0,2,0,5,1,1,0.521667,0.511983,0.516667,0.264925,579,2348,2927,2927,0.5216666666666666,0.5166666666666667,0.264925
50,2011-02-19,1,0,2,0,6,0,1,0.399167,0.391404,0.187917,0.507463,532,1103,1635,1635,0.39916666666666667,0.18791666666666665,0.5074625
51,2011-02-20,1,0,2,0,0,0,1,0.285217,0.27733,0.407826,0.223235,639,1173,1812,1812,0.28521739130434787,0.40782608695652167,0.22323478260869567
52,2011-02-21,1,0,2,1,1,0,2,0.303333,0.284075,0.605,0.307846,195,912,1107,1107,0.30333333333333334,0.605,0.3078458333333333
53,2011-02-22,1,0,2,0,2,1,1,0.182222,0.186033,0.577778,0.195683,74,1376,1450,1450,0.18222222222222223,0.5777777777777778,0.19568333333333332
54,2011-02-23,1,0,2,0,3,1,1,0.221739,0.245717,0.423043,0.094113,139,1778,1917,1917,0.2217391304347826,0.4230434782608696,0.09411304347826087
55,2011-02-24,1,0,2,0,4,1,2,0.295652,0.289191,0.697391,0.250496,100,1707,1807,1807,0.2956521739130435,0.697391304347826,0.25049565217391306
56,2011-02-25,1,0,2,0,5,1,2,0.364348,0.350461,0.712174,0.346539,120,1341,1461,1461,0.36434782608695654,0.7121739130434782,0.34653913043478257
57,2011-02-26,1,0,2,0,6,0,1,0.2825,0.282192,0.537917,0.186571,424,1545,1969,1969,0.28250000000000003,0.5379166666666667,0.18657083333333335
58,2011-02-27,1,0,2,0,0,0,1,0.343478,0.351109,0.68,0.125248,694,1708,2402,2402,0.34347826086956523,0.68,0.12524782608695653
59,2011-02-28,1,0,2,0,1,1,2,0.407273,0.400118,0.876364,0.289686,81,1365,1446,1446,0.4072727272727273,0.8763636363636365,0.28968636363636363
60,2011-03-01,1,0,3,0,2,1,1,0.266667,0.263879,0.535,0.216425,137,1714,1851,1851,0.26666666666666666,0.535,0.216425
61,2011-03-02,1,0,3,0,3,1,1,0.335,0.320071,0.449583,0.307833,231,1903,2134,2134,0.335,0.4495833333333333,0.30783333333333335
62,2011-03-03,1,0,3,0,4,1,1,0.198333,0.200133,0.318333,0.225754,123,1562,1685,1685,0.19833333333333333,0.3183333333333333,0.22575416666666667
63,2011-03-04,1,0,3,0,5,1,2,0.261667,0.255679,0.610417,0.203346,214,1730,1944,1944,0.26166666666666666,0.6104166666666667,0.20334583333333334
64,2011-03-05,1,0,3,0,6,0,2,0.384167,0.378779,0.789167,0.251871,640,1437,2077,2077,0.3841666666666667,0.7891666666666667,0.2518708333333333
65,2011-03-06,1,0,3,0,0,0,2,0.376522,0.366252,0.948261,0.343287,114,491,605,605,0.3765217391304348,0.9482608695652174,0.34328695652173913
66,2011-03-07,1,0,3,0,1,1,1,0.261739,0.238461,0.551304,0.341352,244,1628,1872,1872,0.26173913043478264,0.551304347826087,0.34135217391304346
67,2011-03-08,1,0,3,0,2,1,1,0.2925,0.3024,0.420833,0.12065,316,1817,2133,2133,0.2925,0.42083333333333334,0.12065
68,2011-03-09,1,0,3,0,3,1,2,0.295833,0.286608,0.775417,0.22015,191,1700,1891,1891,0.29583333333333334,0.7754166666666666,0.22014999999999998
69,2011-03-10,1,0,3,0,4,1,3,0.389091,0.385668,0.0,0.261877,46,577,623,623,0.3890909090909091,0.0,0.26187727272727274
70,2011-03-11,1,0,3,0,5,1,2,0.316522,0.305,0.649565,0.23297,247,1730,1977,1977,0.3165217391304348,0.6495652173913044,0.2329695652173913
71,2011-03-12,1,0,3,0,6,0,1,0.329167,0.32575,0.594583,0.220775,724,1408,2132,2132,0.32916666666666666,0.5945833333333334,0.22077500000000003
72,2011-03-13,1,0,3,0,0,0,1,0.384348,0.380091,0.527391,0.270604,982,1435,2417,2417,0.3843478260869565,0.5273913043478261,0.270604347826087
73,2011-03-14,1,0,3,0,1,1,1,0.325217,0.332,0.496957,0.136926,359,1687,2046,2046,0.32521739130434785,0.4969565217391304,0.13692608695652173
74,2011-03-15,1,0,3,0,2,1,2,0.317391,0.318178,0.655652,0.184309,289,1767,2056,2056,0.3173913043478261,0.6556521739130435,0.18430869565217395
75,2011-03-16,1,0,3,0,3,1,2,0.365217,0.36693,0.776522,0.203117,321,1871,2192,2192,0.3652173913043478,0.7765217391304348,0.2031173913043478
76,2011-03-17,1,0,3,0,4,1,1,0.415,0.410333,0.602917,0.209579,424,2320,2744,2744,0.41500000000000004,0.6029166666666667,0.20957916666666665
77,2011-03-18,1,0,3,0,5,1,1,0.54,0.527009,0.525217,0.231017,884,2355,3239,3239,0.54,0.5252173913043479,0.2310173913043478
78,2011-03-19,1,0,3,0,6,0,1,0.4725,0.466525,0.379167,0.368167,1424,1693,3117,3117,0.4725,0.37916666666666665,0.3681666666666667
79,2011-03-20,1,0,3,0,0,0,1,0.3325,0.32575,0.47375,0.207721,1047,1424,2471,2471,0.3325,0.47375000000000006,0.20772083333333335
80,2011-03-21,2,0,3,0,1,1,2,0.430435,0.409735,0.737391,0.288783,401,1676,2077,2077,0.43043478260869567,0.7373913043478261,0.2887826086956522
81,2011-03-22,2,0,3,0,2,1,1,0.441667,0.440642,0.624583,0.22575,460,2243,2703,2703,0.44166666666666665,0.6245833333333334,0.22575
82,2011-03-23,2,0,3,0,3,1,2,0.346957,0.337939,0.839565,0.234261,203,1918,2121,2121,0.34695652173913044,0.8395652173913043,0.23426086956521738
83,2011-03-24,2,0,3,0,4,1,2,0.285,0.270833,0.805833,0.243787,166,1699,1865,1865,0.285,0.8058333333333333,0.24378750000000002
84,2011-03-25,2,0,3,0,5,1,1,0.264167,0.256312,0.495,0.230725,300,1910,2210,2210,0.26416666666666666,0.49499999999999994,0.23072499999999999
85,2011-03-26,2,0,3,0,6,0,1,0.265833,0.257571,0.394167,0.209571,981,1515,2496,2496,0.2658333333333333,0.3941666666666667,0.20957083333333335
86,2011-03-27,2,0,3,0,0,0,2,0.253043,0.250339,0.493913,0.1843,472,1221,1693,1693,0.2530434782608696,0.49391304347826087,0.1843
87,2011-03-28,2,0,3,0,1,1,1,0.264348,0.257574,0.302174,0.212204,222,1806,2028,2028,0.2643478260869565,0.3021739130434783,0.21220434782608696
88,2011-03-29,2,0,3,0,2,1,1,0.3025,0.292908,0.314167,0.226996,317,2108,2425,2425,0.3025,0.31416666666666665,0.2269958333333333
89,2011-03-30,2,0,3,0,3,1,2,0.3,0.29735,0.646667,0.172888,168,1368,1536,1536,0.3,0.6466666666666666,0.1728875
90,2011-03-31,2,0,3,0,4,1,3,0.268333,0.257575,0.918333,0.217646,179,1506,1685,1685,0.26833333333333337,0.9183333333333333,0.21764583333333332
91,2011-04-01,2,0,4,0,5,1,2,0.3,0.283454,0.68625,0.258708,307,1920,2227,2227,0.3,0.6862499999999999,0.2587083333333334
92,2011-04-02,2,0,4,0,6,0,2,0.315,0.315637,0.65375,0.197146,898,1354,2252,2252,0.315,0.6537499999999999,0.19714583333333335
93,2011-04-03,2,0,4,0,0,0,1,0.378333,0.378767,0.48,0.182213,1651,1598,3249,3249,0.37833333333333335,0.48,0.1822125
94,2011-04-04,2,0,4,0,1,1,1,0.573333,0.542929,0.42625,0.385571,734,2381,3115,3115,0.5733333333333334,0.42625,0.38557083333333336
95,2011-04-05,2,0,4,0,2,1,2,0.414167,0.39835,0.642083,0.388067,167,1628,1795,1795,0.4141666666666666,0.6420833333333333,0.3880666666666666
96,2011-04-06,2,0,4,0,3,1,1,0.390833,0.387608,0.470833,0.263063,413,2395,2808,2808,0.39083333333333337,0.47083333333333327,0.26306250000000003
97,2011-04-07,2,0,4,0,4,1,1,0.4375,0.433696,0.602917,0.162312,571,2570,3141,3141,0.4375,0.6029166666666667,0.1623125
98,2011-04-08,2,0,4,0,5,1,2,0.335833,0.324479,0.83625,0.226992,172,1299,1471,1471,0.3358333333333334,0.83625,0.22699166666666667
99,2011-04-09,2,0,4,0,6,0,2,0.3425,0.341529,0.8775,0.133083,879,1576,2455,2455,0.3425,0.8775,0.13308333333333333
100,2011-04-10,2,0,4,0,0,0,2,0.426667,0.426737,0.8575,0.146767,1188,1707,2895,2895,0.4266666666666667,0.8574999999999999,0.14676666666666668
101,2011-04-11,2,0,4,0,1,1,2,0.595652,0.565217,0.716956,0.324474,855,2493,3348,3348,0.5956521739130435,0.7169565217391304,0.3244739130434783
102,2011-04-12,2,0,4,0,2,1,2,0.5025,0.493054,0.739167,0.274879,257,1777,2034,2034,0.5025000000000001,0.7391666666666666,0.2748791666666667
103,2011-04-13,2,0,4,0,3,1,2,0.4125,0.417283,0.819167,0.250617,209,1953,2162,2162,0.41250000000000003,0.8191666666666667,0.25061666666666665
104,2011-04-14,2,0,4,0,4,1,1,0.4675,0.462742,0.540417,0.1107,529,2738,3267,3267,0.4675,0.5404166666666667,0.1107
105,2011-04-15,2,0,4,1,5,0,1,0.446667,0.441913,0.67125,0.226375,642,2484,3126,3126,0.4466666666666667,0.67125,0.226375
106,2011-04-16,2,0,4,0,6,0,3,0.430833,0.425492,0.888333,0.340808,121,674,795,795,0.43083333333333335,0.8883333333333333,0.3408083333333333
107,2011-04-17,2,0,4,0,0,0,1,0.456667,0.445696,0.479583,0.303496,1558,2186,3744,3744,0.4566666666666667,0.4795833333333333,0.30349583333333335
108,2011-04-18,2,0,4,0,1,1,1,0.5125,0.503146,0.5425,0.163567,669,2760,3429,3429,0.5125000000000001,0.5425,0.16356666666666667
109,2011-04-19,2,0,4,0,2,1,2,0.505833,0.489258,0.665833,0.157971,409,2795,3204,3204,0.5058333333333334,0.6658333333333334,0.15797083333333334
110,2011-04-20,2,0,4,0,3,1,1,0.595,0.564392,0.614167,0.241925,613,3331,3944,3944,0.595,0.6141666666666666,0.24192500000000003
111,2011-04-21,2,0,4,0,4,1,1,0.459167,0.453892,0.407083,0.325258,745,3444,4189,4189,0.45916666666666667,0.4070833333333333,0.32525833333333337
112,2011-04-22,2,0,4,0,5,1,2,0.336667,0.321954,0.729583,0.219521,177,1506,1683,1683,0.33666666666666667,0.7295833333333334,0.2195208333333333
113,2011-04-23,2,0,4,0,6,0,2,0.46,0.450121,0.887917,0.230725,1462,2574,4036,4036,0.46,0.8879166666666666,0.23072499999999999
114,2011-04-24,2,0,4,0,0,0,2,0.581667,0.551763,0.810833,0.192175,1710,2481,4191,4191,0.5816666666666667,0.8108333333333334,0.19217499999999998
115,2011-04-25,2,0,4,0,1,1,1,0.606667,0.5745,0.776667,0.185333,773,3300,4073,4073,0.6066666666666667,0.7766666666666667,0.18533333333333335
116,2011-04-26,2,0,4,0,2,1,1,0.631667,0.594083,0.729167,0.3265,678,3722,4400,4400,0.6316666666666667,0.7291666666666666,0.3265
117,2011-04-27,2,0,4,0,3,1,2,0.62,0.575142,0.835417,0.3122,547,3325,3872,3872,0.62,0.8354166666666667,0.3122
118,2011-04-28,2,0,4,0,4,1,2,0.6175,0.578929,0.700833,0.320908,569,3489,4058,4058,0.6175,0.7008333333333333,0.32090833333333335
119,2011-04-29,2,0,4,0,5,1,1,0.51,0.497463,0.457083,0.240063,878,3717,4595,4595,0.51,0.45708333333333334,0.24006249999999998
120,2011-04-30,2,0,4,0,6,0,1,0.4725,0.464021,0.503333,0.235075,1965,3347,5312,5312,0.4725,0.5033333333333333,0.235075
121,2011-05-01,2,0,5,0,0,0,2,0.451667,0.448204,0.762083,0.106354,1138,2213,3351,3351,0.45166666666666666,0.7620833333333333,0.10635416666666668
122,2011-05-02,2,0,5,0,1,1,2,0.549167,0.532833,0.73,0.183454,847,3554,4401,4401,0.5491666666666667,0.73,0.18345416666666667
123,2011-05-03,2,0,5,0,2,1,2,0.616667,0.582079,0.697083,0.342667,603,3848,4451,4451,0.6166666666666667,0.6970833333333334,0.3426666666666667
124,2011-05-04,2,0,5,0,3,1,2,0.414167,0.40465,0.737083,0.328996,255,2378,2633,2633,0.4141666666666666,0.7370833333333334,0.3289958333333333
125,2011-05-05,2,0,5,0,4,1,1,0.459167,0.441917,0.444167,0.295392,614,3819,4433,4433,0.45916666666666667,0.44416666666666665,0.29539166666666666
126,2011-05-06,2,0,5,0,5,1,1,0.479167,0.474117,0.59,0.228246,894,3714,4608,4608,0.4791666666666667,0.59,0.22824583333333334
127,2011-05-07,2,0,5,0,6,0,1,0.52,0.512621,0.54125,0.16045,1612,3102,4714,4714,0.52,0.54125,0.16045
128,2011-05-08,2,0,5,0,0,0,1,0.528333,0.518933,0.631667,0.0746375,1401,2932,4333,4333,0.5283333333333333,0.6316666666666667,0.0746375
129,2011-05-09,2,0,5,0,1,1,1,0.5325,0.525246,0.58875,0.176,664,3698,4362,4362,0.5325,0.58875,0.17600000000000002
130,2011-05-10,2,0,5,0,2,1,1,0.5325,0.522721,0.489167,0.115671,694,4109,4803,4803,0.5325000000000001,0.4891666666666667,0.11567083333333333
131,2011-05-11,2,0,5,0,3,1,1,0.5425,0.5284,0.632917,0.120642,550,3632,4182,4182,0.5425,0.6329166666666667,0.12064166666666666
132,2011-05-12,2,0,5,0,4,1,1,0.535,0.523363,0.7475,0.189667,695,4169,4864,4864,0.535,0.7475,0.18966666666666665
133,2011-05-13,2,0,5,0,5,1,2,0.5125,0.4943,0.863333,0.179725,692,3413,4105,4105,0.5125000000000001,0.8633333333333333,0.17972500000000002
134,2011-05-14,2,0,5,0,6,0,2,0.520833,0.500629,0.9225,0.13495,902,2507,3409,3409,0.5208333333333334,0.9225,0.13495
135,2011-05-15,2,0,5,0,0,0,2,0.5625,0.536,0.867083,0.152979,1582,2971,4553,4553,0.5625,0.8670833333333333,0.15297916666666667
136,2011-05-16,2,0,5,0,1,1,1,0.5775,0.550512,0.787917,0.126871,773,3185,3958,3958,0.5775,0.7879166666666667,0.12687083333333335
137,2011-05-17,2,0,5,0,2,1,2,0.561667,0.538529,0.837917,0.277354,678,3445,4123,4123,0.5616666666666666,0.8379166666666666,0.2773541666666666
138,2011-05-18,2,0,5,0,3,1,2,0.55,0.527158,0.87,0.201492,536,3319,3855,3855,0.55,0.87,0.20149166666666665
139,2011-05-19,2,0,5,0,4,1,2,0.530833,0.510742,0.829583,0.108213,735,3840,4575,4575,0.5308333333333334,0.8295833333333333,0.1082125
140,2011-05-20,2,0,5,0,5,1,1,0.536667,0.529042,0.719583,0.125013,909,4008,4917,4917,0.5366666666666667,0.7195833333333334,0.1250125
141,2011-05-21,2,0,5,0,6,0,1,0.6025,0.571975,0.626667,0.12065,2258,3547,5805,5805,0.6025,0.6266666666666666,0.12065
142,2011-05-22,2,0,5,0,0,0,1,0.604167,0.5745,0.749583,0.148008,1576,3084,4660,4660,0.6041666666666666,0.7495833333333333,0.14800833333333333
143,2011-05-23,2,0,5,0,1,1,2,0.631667,0.590296,0.81,0.233842,836,3438,4274,4274,0.6316666666666667,0.8099999999999999,0.23384166666666664
144,2011-05-24,2,0,5,0,2,1,2,0.66,0.604813,0.740833,0.207092,659,3833,4492,4492,0.66,0.7408333333333333,0.20709166666666667
145,2011-05-25,2,0,5,0,3,1,1,0.660833,0.615542,0.69625,0.154233,740,4238,4978,4978,0.6608333333333333,0.69625,0.15423333333333333
146,2011-05-26,2,0,5,0,4,1,1,0.708333,0.654688,0.6775,0.199642,758,3919,4677,4677,0.7083333333333334,0.6775000000000001,0.1996416666666667
147,2011-05-27,2,0,5,0,5,1,1,0.681667,0.637008,0.65375,0.240679,871,3808,4679,4679,0.6816666666666666,0.6537499999999999,0.24067916666666667
148,2011-05-28,2,0,5,0,6,0,1,0.655833,0.612379,0.729583,0.230092,2001,2757,4758,4758,0.6558333333333334,0.7295833333333334,0.23009166666666667
149,2011-05-29,2,0,5,0,0,0,1,0.6675,0.61555,0.81875,0.213938,2355,2433,4788,4788,0.6675,0.81875,0.2139375
150,2011-05-30,2,0,5,1,1,0,1,0.733333,0.671092,0.685,0.131225,1549,2549,4098,4098,0.7333333333333334,0.6849999999999999,0.131225
151,2011-05-31,2,0,5,0,2,1,1,0.775,0.725383,0.636667,0.111329,673,3309,3982,3982,0.775,0.6366666666666666,0.11132916666666666
152,2011-06-01,2,0,6,0,3,1,2,0.764167,0.720967,0.677083,0.207092,513,3461,3974,3974,0.7641666666666667,0.6770833333333334,0.20709166666666667
153,2011-06-02,2,0,6,0,4,1,1,0.715,0.643942,0.305,0.292287,736,4232,4968,4968,0.715,0.305,0.2922875
154,2011-06-03,2,0,6,0,5,1,1,0.62,0.587133,0.354167,0.253121,898,4414,5312,5312,0.62,0.3541666666666667,0.25312083333333335
155,2011-06-04,2,0,6,0,6,0,1,0.635,0.594696,0.45625,0.123142,1869,3473,5342,5342,0.635,0.45625,0.12314166666666666
156,2011-06-05,2,0,6,0,0,0,2,0.648333,0.616804,0.6525,0.138692,1685,3221,4906,4906,0.6483333333333333,0.6525,0.13869166666666669
157,2011-06-06,2,0,6,0,1,1,1,0.678333,0.621858,0.6,0.121896,673,3875,4548,4548,0.6783333333333333,0.6,0.12189583333333333
158,2011-06-07,2,0,6,0,2,1,1,0.7075,0.65595,0.597917,0.187808,763,4070,4833,4833,0.7075,0.5979166666666667,0.18780833333333333
159,2011-06-08,2,0,6,0,3,1,1,0.775833,0.727279,0.622083,0.136817,676,3725,4401,4401,0.7758333333333334,0.6220833333333333,0.13681666666666667
160,2011-06-09,2,0,6,0,4,1,2,0.808333,0.757579,0.568333,0.149883,563,3352,3915,3915,0.8083333333333332,0.5683333333333334,0.14988333333333334
161,2011-06-10,2,0,6,0,5,1,1,0.755,0.703292,0.605,0.140554,815,3771,4586,4586,0.755,0.605,0.14055416666666667
162,2011-06-11,2,0,6,0,6,0,1,0.725,0.678038,0.654583,0.15485,1729,3237,4966,4966,0.725,0.6545833333333334,0.15485000000000002
163,2011-06-12,2,0,6,0,0,0,1,0.6925,0.643325,0.747917,0.163567,1467,2993,4460,4460,0.6925,0.7479166666666667,0.16356666666666667
164,2011-06-13,2,0,6,0,1,1,1,0.635,0.601654,0.494583,0.30535,863,4157,5020,5020,0.635,0.4945833333333333,0.30535
165,2011-06-14,2,0,6,0,2,1,1,0.604167,0.591546,0.507083,0.269283,727,4164,4891,4891,0.6041666666666666,0.5070833333333333,0.2692833333333333
166,2011-06-15,2,0,6,0,3,1,1,0.626667,0.587754,0.471667,0.167912,769,4411,5180,5180,0.6266666666666666,0.4716666666666667,0.16791250000000002
167,2011-06-16,2,0,6,0,4,1,2,0.628333,0.595346,0.688333,0.206471,545,3222,3767,3767,0.6283333333333333,0.6883333333333334,0.20647083333333335
168,2011-06-17,2,0,6,0,5,1,1,0.649167,0.600383,0.735833,0.143029,863,3981,4844,4844,0.6491666666666667,0.7358333333333333,0.14302916666666668
169,2011-06-18,2,0,6,0,6,0,1,0.696667,0.643954,0.670417,0.119408,1807,3312,5119,5119,0.6966666666666667,0.6704166666666667,0.11940833333333334
170,2011-06-19,2,0,6,0,0,0,2,0.699167,0.645846,0.666667,0.102,1639,3105,4744,4744,0.6991666666666667,0.6666666666666666,0.102
171,2011-06-20,2,0,6,0,1,1,2,0.635,0.595346,0.74625,0.155475,699,3311,4010,4010,0.635,0.74625,0.155475
172,2011-06-21,3,0,6,0,2,1,2,0.680833,0.637646,0.770417,0.171025,774,4061,4835,4835,0.6808333333333333,0.7704166666666666,0.17102499999999998
173,2011-06-22,3,0,6,0,3,1,1,0.733333,0.693829,0.7075,0.172262,661,3846,4507,4507,0.7333333333333334,0.7075,0.17226249999999999
174,2011-06-23,3,0,6,0,4,1,2,0.728333,0.693833,0.703333,0.238804,746,4044,4790,4790,0.7283333333333334,0.7033333333333333,0.23880416666666668
175,2011-06-24,3,0,6,0,5,1,1,0.724167,0.656583,0.573333,0.222025,969,4022,4991,4991,0.7241666666666666,0.5733333333333334,0.222025
176,2011-06-25,3,0,6,0,6,0,1,0.695,0.643313,0.483333,0.209571,1782,3420,5202,5202,0.695,0.48333333333333334,0.20957083333333335
177,2011-06-26,3,0,6,0,0,0,1,0.68,0.637629,0.513333,0.0945333,1920,3385,5305,5305,0.68,0.5133333333333333,0.09453333333333334
178,2011-06-27,3,0,6,0,1,1,2,0.6825,0.637004,0.658333,0.107588,854,3854,4708,4708,0.6825,0.6583333333333333,0.1075875
179,2011-06-28,3,0,6,0,2,1,1,0.744167,0.692558,0.634167,0.144283,732,3916,4648,4648,0.7441666666666666,0.6341666666666667,0.14428333333333335
180,2011-06-29,3,0,6,0,3,1,1,0.728333,0.654688,0.497917,0.261821,848,4377,5225,5225,0.7283333333333334,0.4979166666666666,0.26182083333333334
181,2011-06-30,3,0,6,0,4,1,1,0.696667,0.637008,0.434167,0.185312,1027,4488,5515,5515,0.6966666666666667,0.43416666666666665,0.1853125
182,2011-07-01,3,0,7,0,5,1,1,0.7225,0.652162,0.39625,0.102608,1246,4116,5362,5362,0.7225,0.39625,0.10260833333333334
183,2011-07-02,3,0,7,0,6,0,1,0.738333,0.667308,0.444583,0.115062,2204,2915,5119,5119,0.7383333333333333,0.44458333333333333,0.1150625
184,2011-07-03,3,0,7,0,0,0,2,0.716667,0.668575,0.6825,0.228858,2282,2367,4649,4649,0.7166666666666667,0.6825,0.2288583333333333
185,2011-07-04,3,0,7,1,1,0,2,0.726667,0.665417,0.637917,0.0814792,3065,2978,6043,6043,0.7266666666666667,0.6379166666666667,0.08147916666666667
186,2011-07-05,3,0,7,0,2,1,1,0.746667,0.696338,0.590417,0.126258,1031,3634,4665,4665,0.7466666666666667,0.5904166666666667,0.12625833333333333
187,2011-07-06,3,0,7,0,3,1,1,0.72,0.685633,0.743333,0.149883,784,3845,4629,4629,0.7200000000000001,0.7433333333333333,0.14988333333333334
188,2011-07-07,3,0,7,0,4,1,1,0.75,0.686871,0.65125,0.1592,754,3838,4592,4592,0.75,0.65125,0.1592
189,2011-07-08,3,0,7,0,5,1,2,0.709167,0.670483,0.757917,0.225129,692,3348,4040,4040,0.7091666666666666,0.7579166666666667,0.22512916666666669
190,2011-07-09,3,0,7,0,6,0,1,0.733333,0.664158,0.609167,0.167912,1988,3348,5336,5336,0.7333333333333334,0.6091666666666666,0.16791250000000002
191,2011-07-10,3,0,7,0,0,0,1,0.7475,0.690025,0.578333,0.183471,1743,3138,4881,4881,0.7475,0.5783333333333334,0.18347083333333333
192,2011-07-11,3,0,7,0,1,1,1,0.7625,0.729804,0.635833,0.282337,723,3363,4086,4086,0.7625000000000001,0.6358333333333334,0.28233749999999996
193,2011-07-12,3,0,7,0,2,1,1,0.794167,0.739275,0.559167,0.200254,662,3596,4258,4258,0.7941666666666666,0.5591666666666667,0.20025416666666665
194,2011-07-13,3,0,7,0,3,1,1,0.746667,0.689404,0.631667,0.146133,748,3594,4342,4342,0.7466666666666666,0.6316666666666667,0.14613333333333334
195,2011-07-14,3,0,7,0,4,1,1,0.680833,0.635104,0.47625,0.240667,888,4196,5084,5084,0.6808333333333333,0.47625,0.24066666666666667
196,2011-07-15,3,0,7,0,5,1,1,0.663333,0.624371,0.59125,0.182833,1318,4220,5538,5538,0.6633333333333333,0.5912499999999999,0.18283333333333332
197,2011-07-16,3,0,7,0,6,0,1,0.686667,0.638263,0.585,0.208342,2418,3505,5923,5923,0.6866666666666666,0.5850000000000001,0.20834166666666668
198,2011-07-17,3,0,7,0,0,0,1,0.719167,0.669833,0.604167,0.245033,2006,3296,5302,5302,0.7191666666666667,0.6041666666666666,0.24503333333333333
199,2011-07-18,3,0,7,0,1,1,1,0.746667,0.703925,0.65125,0.215804,841,3617,4458,4458,0.7466666666666667,0.65125,0.21580416666666669
200,2011-07-19,3,0,7,0,2,1,1,0.776667,0.747479,0.650417,0.1306,752,3789,4541,4541,0.7766666666666667,0.6504166666666666,0.13060000000000002
201,2011-07-20,3,0,7,0,3,1,1,0.768333,0.74685,0.707083,0.113817,644,3688,4332,4332,0.7683333333333334,0.7070833333333333,0.11381666666666666
202,2011-07-21,3,0,7,0,4,1,2,0.815,0.826371,0.69125,0.222021,632,3152,3784,3784,0.815,0.69125,0.22202083333333333
203,2011-07-22,3,0,7,0,5,1,1,0.848333,0.840896,0.580417,0.1331,562,2825,3387,3387,0.8483333333333333,0.5804166666666667,0.1331
204,2011-07-23,3,0,7,0,6,0,1,0.849167,0.804287,0.5,0.131221,987,2298,3285,3285,0.8491666666666666,0.5,0.13122083333333331
205,2011-07-24,3,0,7,0,0,0,1,0.83,0.794829,0.550833,0.169171,1050,2556,3606,3606,0.8300000000000001,0.5508333333333334,0.16917083333333335
206,2011-07-25,3,0,7,0,1,1,1,0.743333,0.720958,0.757083,0.0908083,568,3272,3840,3840,0.7433333333333333,0.7570833333333332,0.09080833333333332
207,2011-07-26,3,0,7,0,2,1,1,0.771667,0.696979,0.540833,0.200258,750,3840,4590,4590,0.7716666666666666,0.5408333333333334,0.20025833333333332
208,2011-07-27,3,0,7,0,3,1,1,0.775,0.690667,0.402917,0.183463,755,3901,4656,4656,0.775,0.40291666666666665,0.1834625
209,2011-07-28,3,0,7,0,4,1,1,0.779167,0.7399,0.583333,0.178479,606,3784,4390,4390,0.7791666666666667,0.5833333333333334,0.17847916666666666
210,2011-07-29,3,0,7,0,5,1,1,0.838333,0.785967,0.5425,0.174138,670,3176,3846,3846,0.8383333333333334,0.5425,0.17413750000000003
211,2011-07-30,3,0,7,0,6,0,1,0.804167,0.728537,0.465833,0.168537,1559,2916,4475,4475,0.8041666666666667,0.4658333333333333,0.1685375
212,2011-07-31,3,0,7,0,0,0,1,0.805833,0.729796,0.480833,0.164813,1524,2778,4302,4302,0.8058333333333333,0.4808333333333333,0.1648125
213,2011-08-01,3,0,8,0,1,1,1,0.771667,0.703292,0.550833,0.156717,729,3537,4266,4266,0.7716666666666666,0.5508333333333333,0.15671666666666667
214,2011-08-02,3,0,8,0,2,1,1,0.783333,0.707071,0.49125,0.20585,801,4044,4845,4845,0.7833333333333333,0.49124999999999996,0.20585
215,2011-08-03,3,0,8,0,3,1,2,0.731667,0.679937,0.6575,0.135583,467,3107,3574,3574,0.7316666666666666,0.6575,0.13558333333333333
216,2011-08-04,3,0,8,0,4,1,2,0.71,0.664788,0.7575,0.19715,799,3777,4576,4576,0.71,0.7575,0.19715000000000002
217,2011-08-05,3,0,8,0,5,1,1,0.710833,0.656567,0.630833,0.184696,1023,3843,4866,4866,0.7108333333333333,0.6308333333333334,0.1846958333333333
218,2011-08-06,3,0,8,0,6,0,2,0.716667,0.676154,0.755,0.22825,1521,2773,4294,4294,0.7166666666666667,0.755,0.22824999999999998
219,2011-08-07,3,0,8,0,0,0,1,0.7425,0.715292,0.752917,0.201487,1298,2487,3785,3785,0.7425,0.7529166666666667,0.2014875
220,2011-08-08,3,0,8,0,1,1,1,0.765,0.703283,0.592083,0.192175,846,3480,4326,4326,0.765,0.5920833333333334,0.19217499999999998
221,2011-08-09,3,0,8,0,2,1,1,0.775,0.724121,0.570417,0.151121,907,3695,4602,4602,0.775,0.5704166666666667,0.15112083333333334
222,2011-08-10,3,0,8,0,3,1,1,0.766667,0.684983,0.424167,0.200258,884,3896,4780,4780,0.7666666666666666,0.42416666666666664,0.20025833333333332
223,2011-08-11,3,0,8,0,4,1,1,0.7175,0.651521,0.42375,0.164796,812,3980,4792,4792,0.7174999999999999,0.42375,0.16479583333333334
224,2011-08-12,3,0,8,0,5,1,1,0.708333,0.654042,0.415,0.125621,1051,3854,4905,4905,0.7083333333333334,0.41500000000000004,0.12562083333333332
225,2011-08-13,3,0,8,0,6,0,2,0.685833,0.645858,0.729583,0.211454,1504,2646,4150,4150,0.6858333333333334,0.7295833333333333,0.2114541666666667
226,2011-08-14,3,0,8,0,0,0,2,0.676667,0.624388,0.8175,0.222633,1338,2482,3820,3820,0.6766666666666666,0.8175,0.22263333333333335
227,2011-08-15,3,0,8,0,1,1,1,0.665833,0.616167,0.712083,0.208954,775,3563,4338,4338,0.6658333333333334,0.7120833333333333,0.20895416666666666
228,2011-08-16,3,0,8,0,2,1,1,0.700833,0.645837,0.578333,0.236329,721,4004,4725,4725,0.7008333333333333,0.5783333333333333,0.23632916666666667
229,2011-08-17,3,0,8,0,3,1,1,0.723333,0.666671,0.575417,0.143667,668,4026,4694,4694,0.7233333333333333,0.5754166666666667,0.14366666666666666
230,2011-08-18,3,0,8,0,4,1,1,0.711667,0.662258,0.654583,0.233208,639,3166,3805,3805,0.7116666666666668,0.6545833333333334,0.23320833333333335
231,2011-08-19,3,0,8,0,5,1,2,0.685,0.633221,0.722917,0.139308,797,3356,4153,4153,0.685,0.7229166666666668,0.13930833333333334
232,2011-08-20,3,0,8,0,6,0,1,0.6975,0.648996,0.674167,0.104467,1914,3277,5191,5191,0.6974999999999999,0.6741666666666667,0.10446666666666667
233,2011-08-21,3,0,8,0,0,0,1,0.710833,0.675525,0.77,0.248754,1249,2624,3873,3873,0.7108333333333333,0.77,0.2487541666666667
234,2011-08-22,3,0,8,0,1,1,1,0.691667,0.638254,0.47,0.27675,833,3925,4758,4758,0.6916666666666668,0.47,0.27675
235,2011-08-23,3,0,8,0,2,1,1,0.640833,0.606067,0.455417,0.146763,1281,4614,5895,5895,0.6408333333333333,0.45541666666666664,0.1467625
236,2011-08-24,3,0,8,0,3,1,1,0.673333,0.630692,0.605,0.253108,949,4181,5130,5130,0.6733333333333333,0.605,0.2531083333333333
237,2011-08-25,3,0,8,0,4,1,2,0.684167,0.645854,0.771667,0.210833,435,3107,3542,3542,0.6841666666666667,0.7716666666666666,0.21083333333333334
238,2011-08-26,3,0,8,0,5,1,1,0.7,0.659733,0.76125,0.0839625,768,3893,4661,4661,0.7000000000000001,0.76125,0.0839625
239,2011-08-27,3,0,8,0,6,0,2,0.68,0.635556,0.85,0.375617,226,889,1115,1115,0.68,0.85,0.37561666666666665
240,2011-08-28,3,0,8,0,0,0,1,0.707059,0.647959,0.561765,0.304659,1415,2919,4334,4334,0.7070588235294117,0.5617647058823529,0.30465882352941176
241,2011-08-29,3,0,8,0,1,1,1,0.636667,0.607958,0.554583,0.159825,729,3905,4634,4634,0.6366666666666666,0.5545833333333333,0.159825
242,2011-08-30,3,0,8,0,2,1,1,0.639167,0.594704,0.548333,0.125008,775,4429,5204,5204,0.6391666666666667,0.5483333333333333,0.12500833333333333
243,2011-08-31,3,0,8,0,3,1,1,0.656667,0.611121,0.597917,0.0833333,688,4370,5058,5058,0.6566666666666666,0.5979166666666667,0.08333333333333333
244,2011-09-01,3,0,9,0,4,1,1,0.655,0.614921,0.639167,0.141796,783,4332,5115,5115,0.655,0.6391666666666667,0.14179583333333332
245,2011-09-02,3,0,9,0,5,1,2,0.643333,0.604808,0.727083,0.139929,875,3852,4727,4727,0.6433333333333333,0.7270833333333333,0.13992916666666666
246,2011-09-03,3,0,9,0,6,0,1,0.669167,0.633213,0.716667,0.185325,1935,2549,4484,4484,0.6691666666666666,0.7166666666666667,0.185325
247,2011-09-04,3,0,9,0,0,0,1,0.709167,0.665429,0.742083,0.206467,2521,2419,4940,4940,0.7091666666666666,0.7420833333333333,0.2064666666666667
248,2011-09-05,3,0,9,1,1,0,2,0.673333,0.625646,0.790417,0.212696,1236,2115,3351,3351,0.6733333333333333,0.7904166666666667,0.21269583333333333
249,2011-09-06,3,0,9,0,2,1,3,0.54,0.5152,0.886957,0.343943,204,2506,2710,2710,0.54,0.8869565217391304,0.3439434782608696
250,2011-09-07,3,0,9,0,3,1,3,0.599167,0.544229,0.917083,0.0970208,118,1878,1996,1996,0.5991666666666667,0.9170833333333333,0.09702083333333333
251,2011-09-08,3,0,9,0,4,1,3,0.633913,0.555361,0.939565,0.192748,153,1689,1842,1842,0.6339130434782608,0.9395652173913043,0.19274782608695654
252,2011-09-09,3,0,9,0,5,1,2,0.65,0.578946,0.897917,0.124379,417,3127,3544,3544,0.65,0.8979166666666667,0.12437916666666667
253,2011-09-10,3,0,9,0,6,0,1,0.66,0.607962,0.75375,0.153608,1750,3595,5345,5345,0.66,0.75375,0.15360833333333332
254,2011-09-11,3,0,9,0,0,0,1,0.653333,0.609229,0.71375,0.115054,1633,3413,5046,5046,0.6533333333333333,0.71375,0.11505416666666667
255,2011-09-12,3,0,9,0,1,1,1,0.644348,0.60213,0.692174,0.088913,690,4023,4713,4713,0.6443478260869565,0.6921739130434783,0.08891304347826087
256,2011-09-13,3,0,9,0,2,1,1,0.650833,0.603554,0.7125,0.141804,701,4062,4763,4763,0.6508333333333333,0.7125,0.14180416666666668
257,2011-09-14,3,0,9,0,3,1,1,0.673333,0.6269,0.697083,0.1673,647,4138,4785,4785,0.6733333333333333,0.6970833333333334,0.1673
258,2011-09-15,3,0,9,0,4,1,2,0.5775,0.553671,0.709167,0.271146,428,3231,3659,3659,0.5775,0.7091666666666666,0.27114583333333336
259,2011-09-16,3,0,9,0,5,1,2,0.469167,0.461475,0.590417,0.164183,742,4018,4760,4760,0.4691666666666667,0.5904166666666667,0.16418333333333332
260,2011-09-17,3,0,9,0,6,0,2,0.491667,0.478512,0.718333,0.189675,1434,3077,4511,4511,0.4916666666666667,0.7183333333333333,0.189675
261,2011-09-18,3,0,9,0,0,0,1,0.5075,0.490537,0.695,0.178483,1353,2921,4274,4274,0.5075,0.695,0.17848333333333333
262,2011-09-19,3,0,9,0,1,1,2,0.549167,0.529675,0.69,0.151742,691,3848,4539,4539,0.5491666666666667,0.69,0.15174166666666666
263,2011-09-20,3,0,9,0,2,1,2,0.561667,0.532217,0.88125,0.134954,438,3203,3641,3641,0.5616666666666666,0.88125,0.13495416666666668
264,2011-09-21,3,0,9,0,3,1,2,0.595,0.550533,0.9,0.0964042,539,3813,4352,4352,0.5950000000000001,0.9,0.09640416666666667
265,2011-09-22,3,0,9,0,4,1,2,0.628333,0.554963,0.902083,0.128125,555,4240,4795,4795,0.6283333333333333,0.9020833333333332,0.12812500000000002
266,2011-09-23,4,0,9,0,5,1,2,0.609167,0.522125,0.9725,0.0783667,258,2137,2395,2395,0.6091666666666666,0.9725,0.07836666666666667
267,2011-09-24,4,0,9,0,6,0,2,0.606667,0.564412,0.8625,0.0783833,1776,3647,5423,5423,0.6066666666666667,0.8624999999999999,0.07838333333333333
268,2011-09-25,4,0,9,0,0,0,2,0.634167,0.572637,0.845,0.0503792,1544,3466,5010,5010,0.6341666666666667,0.8450000000000001,0.05037916666666667
269,2011-09-26,4,0,9,0,1,1,2,0.649167,0.589042,0.848333,0.1107,684,3946,4630,4630,0.6491666666666667,0.8483333333333333,0.1107
270,2011-09-27,4,0,9,0,2,1,2,0.636667,0.574525,0.885417,0.118171,477,3643,4120,4120,0.6366666666666666,0.8854166666666666,0.11817083333333334
271,2011-09-28,4,0,9,0,3,1,2,0.635,0.575158,0.84875,0.148629,480,3427,3907,3907,0.635,0.84875,0.14862916666666667
272,2011-09-29,4,0,9,0,4,1,1,0.616667,0.574512,0.699167,0.172883,653,4186,4839,4839,0.6166666666666667,0.6991666666666667,0.17288333333333336
273,2011-09-30,4,0,9,0,5,1,1,0.564167,0.544829,0.6475,0.206475,830,4372,5202,5202,0.5641666666666667,0.6475,0.206475
274,2011-10-01,4,0,10,0,6,0,2,0.41,0.412863,0.75375,0.292296,480,1949,2429,2429,0.41,0.75375,0.29229583333333337
275,2011-10-02,4,0,10,0,0,0,2,0.356667,0.345317,0.791667,0.222013,616,2302,2918,2918,0.3566666666666667,0.7916666666666666,0.22201249999999997
276,2011-10-03,4,0,10,0,1,1,2,0.384167,0.392046,0.760833,0.0833458,330,3240,3570,3570,0.3841666666666667,0.7608333333333334,0.08334583333333334
277,2011-10-04,4,0,10,0,2,1,1,0.484167,0.472858,0.71,0.205854,486,3970,4456,4456,0.4841666666666667,0.71,0.20585416666666667
278,2011-10-05,4,0,10,0,3,1,1,0.538333,0.527138,0.647917,0.17725,559,4267,4826,4826,0.5383333333333333,0.6479166666666667,0.17725000000000002
279,2011-10-06,4,0,10,0,4,1,1,0.494167,0.480425,0.620833,0.134954,639,4126,4765,4765,0.49416666666666664,0.6208333333333333,0.13495416666666668
280,2011-10-07,4,0,10,0,5,1,1,0.510833,0.504404,0.684167,0.0223917,949,4036,4985,4985,0.5108333333333334,0.6841666666666667,0.022391666666666667
281,2011-10-08,4,0,10,0,6,0,1,0.521667,0.513242,0.70125,0.0454042,2235,3174,5409,5409,0.5216666666666666,0.7012499999999999,0.04540416666666667
282,2011-10-09,4,0,10,0,0,0,1,0.540833,0.523983,0.7275,0.06345,2397,3114,5511,5511,0.5408333333333334,0.7275,0.06344999999999999
283,2011-10-10,4,0,10,1,1,0,1,0.570833,0.542925,0.73375,0.0423042,1514,3603,5117,5117,0.5708333333333333,0.73375,0.04230416666666667
284,2011-10-11,4,0,10,0,2,1,2,0.566667,0.546096,0.80875,0.143042,667,3896,4563,4563,0.5666666666666667,0.80875,0.14304166666666665
285,2011-10-12,4,0,10,0,3,1,3,0.543333,0.517717,0.90625,0.24815,217,2199,2416,2416,0.5433333333333333,0.90625,0.24815
286,2011-10-13,4,0,10,0,4,1,2,0.589167,0.551804,0.896667,0.141787,290,2623,2913,2913,0.5891666666666667,0.8966666666666666,0.14178749999999998
287,2011-10-14,4,0,10,0,5,1,2,0.550833,0.529675,0.71625,0.223883,529,3115,3644,3644,0.5508333333333334,0.71625,0.22388333333333335
288,2011-10-15,4,0,10,0,6,0,1,0.506667,0.498725,0.483333,0.258083,1899,3318,5217,5217,0.5066666666666667,0.48333333333333334,0.25808333333333333
289,2011-10-16,4,0,10,0,0,0,1,0.511667,0.503154,0.486667,0.281717,1748,3293,5041,5041,0.5116666666666667,0.48666666666666664,0.28171666666666667
290,2011-10-17,4,0,10,0,1,1,1,0.534167,0.510725,0.579583,0.175379,713,3857,4570,4570,0.5341666666666667,0.5795833333333333,0.17537916666666667
291,2011-10-18,4,0,10,0,2,1,2,0.5325,0.522721,0.701667,0.110087,637,4111,4748,4748,0.5325000000000001,0.7016666666666667,0.1100875
292,2011-10-19,4,0,10,0,3,1,3,0.541739,0.513848,0.895217,0.243339,254,2170,2424,2424,0.5417391304347826,0.8952173913043479,0.2433391304347826
293,2011-10-20,4,0,10,0,4,1,1,0.475833,0.466525,0.63625,0.422275,471,3724,4195,4195,0.47583333333333333,0.63625,0.42227499999999996
294,2011-10-21,4,0,10,0,5,1,1,0.4275,0.423596,0.574167,0.221396,676,3628,4304,4304,0.4275,0.5741666666666666,0.22139583333333335
295,2011-10-22,4,0,10,0,6,0,1,0.4225,0.425492,0.629167,0.0926667,1499,2809,4308,4308,0.42250000000000004,0.6291666666666667,0.09266666666666666
296,2011-10-23,4,0,10,0,0,0,1,0.421667,0.422333,0.74125,0.0995125,1619,2762,4381,4381,0.4216666666666667,0.74125,0.0995125
297,2011-10-24,4,0,10,0,1,1,1,0.463333,0.457067,0.772083,0.118792,699,3488,4187,4187,0.4633333333333334,0.7720833333333333,0.11879166666666667
298,2011-10-25,4,0,10,0,2,1,1,0.471667,0.463375,0.622917,0.166658,695,3992,4687,4687,0.4716666666666667,0.6229166666666667,0.16665833333333332
299,2011-10-26,4,0,10,0,3,1,2,0.484167,0.472846,0.720417,0.148642,404,3490,3894,3894,0.48416666666666663,0.7204166666666666,0.14864166666666667
300,2011-10-27,4,0,10,0,4,1,2,0.47,0.457046,0.812917,0.197763,240,2419,2659,2659,0.47,0.8129166666666666,0.19776249999999998
301,2011-10-28,4,0,10,0,5,1,2,0.330833,0.318812,0.585833,0.229479,456,3291,3747,3747,0.33083333333333337,0.5858333333333333,0.22947916666666668
302,2011-10-29,4,0,10,0,6,0,3,0.254167,0.227913,0.8825,0.351371,57,570,627,627,0.25416666666666665,0.8825,0.35137083333333335
303,2011-10-30,4,0,10,0,0,0,1,0.319167,0.321329,0.62375,0.176617,885,2446,3331,3331,0.31916666666666665,0.62375,0.17661666666666667
304,2011-10-31,4,0,10,0,1,1,1,0.34,0.356063,0.703333,0.10635,362,3307,3669,3669,0.34,0.7033333333333333,0.10635
305,2011-11-01,4,0,11,0,2,1,1,0.400833,0.397088,0.68375,0.135571,410,3658,4068,4068,0.4008333333333333,0.68375,0.13557083333333333
306,2011-11-02,4,0,11,0,3,1,1,0.3775,0.390133,0.71875,0.0820917,370,3816,4186,4186,0.3775,0.71875,0.08209166666666667
307,2011-11-03,4,0,11,0,4,1,1,0.408333,0.405921,0.702083,0.136817,318,3656,3974,3974,0.4083333333333334,0.7020833333333334,0.13681666666666667
308,2011-11-04,4,0,11,0,5,1,2,0.403333,0.403392,0.6225,0.271779,470,3576,4046,4046,0.4033333333333333,0.6224999999999999,0.2717791666666667
309,2011-11-05,4,0,11,0,6,0,1,0.326667,0.323854,0.519167,0.189062,1156,2770,3926,3926,0.32666666666666666,0.5191666666666667,0.1890625
310,2011-11-06,4,0,11,0,0,0,1,0.348333,0.362358,0.734583,0.0920542,952,2697,3649,3649,0.34833333333333333,0.7345833333333333,0.09205416666666666
311,2011-11-07,4,0,11,0,1,1,1,0.395,0.400871,0.75875,0.057225,373,3662,4035,4035,0.395,0.75875,0.057225
312,2011-11-08,4,0,11,0,2,1,1,0.408333,0.412246,0.721667,0.0690375,376,3829,4205,4205,0.4083333333333334,0.7216666666666667,0.0690375
313,2011-11-09,4,0,11,0,3,1,1,0.4,0.409079,0.758333,0.0621958,305,3804,4109,4109,0.39999999999999997,0.7583333333333333,0.06219583333333333
314,2011-11-10,4,0,11,0,4,1,2,0.38,0.373721,0.813333,0.189067,190,2743,2933,2933,0.37999999999999995,0.8133333333333334,0.1890666666666667
315,2011-11-11,4,0,11,1,5,0,1,0.324167,0.306817,0.44625,0.314675,440,2928,3368,3368,0.32416666666666666,0.44625000000000004,0.314675
316,2011-11-12,4,0,11,0,6,0,1,0.356667,0.357942,0.552917,0.212062,1275,2792,4067,4067,0.3566666666666667,0.5529166666666666,0.21206250000000001
317,2011-11-13,4,0,11,0,0,0,1,0.440833,0.43055,0.458333,0.281721,1004,2713,3717,3717,0.44083333333333335,0.4583333333333333,0.28172083333333336
318,2011-11-14,4,0,11,0,1,1,1,0.53,0.524612,0.587083,0.306596,595,3891,4486,4486,0.53,0.5870833333333333,0.30659583333333335
319,2011-11-15,4,0,11,0,2,1,2,0.53,0.507579,0.68875,0.199633,449,3746,4195,4195,0.53,0.6887500000000001,0.19963333333333333
320,2011-11-16,4,0,11,0,3,1,3,0.456667,0.451988,0.93,0.136829,145,1672,1817,1817,0.4566666666666667,0.93,0.13682916666666667
321,2011-11-17,4,0,11,0,4,1,2,0.341667,0.323221,0.575833,0.305362,139,2914,3053,3053,0.3416666666666666,0.5758333333333333,0.3053625
322,2011-11-18,4,0,11,0,5,1,1,0.274167,0.272721,0.41,0.168533,245,3147,3392,3392,0.27416666666666667,0.41,0.16853333333333334
323,2011-11-19,4,0,11,0,6,0,1,0.329167,0.324483,0.502083,0.224496,943,2720,3663,3663,0.32916666666666666,0.5020833333333333,0.22449583333333334
324,2011-11-20,4,0,11,0,0,0,2,0.463333,0.457058,0.684583,0.18595,787,2733,3520,3520,0.4633333333333334,0.6845833333333333,0.18594999999999998
325,2011-11-21,4,0,11,0,1,1,3,0.4475,0.445062,0.91,0.138054,220,2545,2765,2765,0.4475,0.91,0.13805416666666667
326,2011-11-22,4,0,11,0,2,1,3,0.416667,0.421696,0.9625,0.118792,69,1538,1607,1607,0.4166666666666667,0.9624999999999999,0.11879166666666667
327,2011-11-23,4,0,11,0,3,1,2,0.440833,0.430537,0.757917,0.335825,112,2454,2566,2566,0.44083333333333335,0.7579166666666666,0.335825
328,2011-11-24,4,0,11,1,4,0,1,0.373333,0.372471,0.549167,0.167304,560,935,1495,1495,0.37333333333333335,0.5491666666666667,0.16730416666666667
329,2011-11-25,4,0,11,0,5,1,1,0.375,0.380671,0.64375,0.0988958,1095,1697,2792,2792,0.375,0.64375,0.09889583333333334
330,2011-11-26,4,0,11,0,6,0,1,0.375833,0.385087,0.681667,0.0684208,1249,1819,3068,3068,0.3758333333333333,0.6816666666666666,0.06842083333333333
331,2011-11-27,4,0,11,0,0,0,1,0.459167,0.4558,0.698333,0.208954,810,2261,3071,3071,0.45916666666666667,0.6983333333333334,0.20895416666666666
332,2011-11-28,4,0,11,0,1,1,1,0.503478,0.490122,0.743043,0.142122,253,3614,3867,3867,0.5034782608695653,0.7430434782608696,0.14212173913043477
333,2011-11-29,4,0,11,0,2,1,2,0.458333,0.451375,0.830833,0.258092,96,2818,2914,2914,0.4583333333333333,0.8308333333333334,0.25809166666666666
334,2011-11-30,4,0,11,0,3,1,1,0.325,0.311221,0.613333,0.271158,188,3425,3613,3613,0.325,0.6133333333333334,0.27115833333333333
335,2011-12-01,4,0,12,0,4,1,1,0.3125,0.305554,0.524583,0.220158,182,3545,3727,3727,0.3125,0.5245833333333333,0.22015833333333334
336,2011-12-02,4,0,12,0,5,1,1,0.314167,0.331433,0.625833,0.100754,268,3672,3940,3940,0.31416666666666665,0.6258333333333334,0.10075416666666666
337,2011-12-03,4,0,12,0,6,0,1,0.299167,0.310604,0.612917,0.0957833,706,2908,3614,3614,0.29916666666666664,0.6129166666666667,0.09578333333333333
338,2011-12-04,4,0,12,0,0,0,1,0.330833,0.3491,0.775833,0.0839583,634,2851,3485,3485,0.33083333333333337,0.7758333333333334,0.08395833333333334
339,2011-12-05,4,0,12,0,1,1,2,0.385833,0.393925,0.827083,0.0622083,233,3578,3811,3811,0.3858333333333333,0.8270833333333334,0.06220833333333333
340,2011-12-06,4,0,12,0,2,1,3,0.4625,0.4564,0.949583,0.232583,126,2468,2594,2594,0.46249999999999997,0.9495833333333333,0.23258333333333334
341,2011-12-07,4,0,12,0,3,1,3,0.41,0.400246,0.970417,0.266175,50,655,705,705,0.41,0.9704166666666666,0.266175
342,2011-12-08,4,0,12,0,4,1,1,0.265833,0.256938,0.58,0.240058,150,3172,3322,3322,0.2658333333333333,0.58,0.24005833333333335
343,2011-12-09,4,0,12,0,5,1,1,0.290833,0.317542,0.695833,0.0827167,261,3359,3620,3620,0.29083333333333333,0.6958333333333333,0.08271666666666667
344,2011-12-10,4,0,12,0,6,0,1,0.275,0.266412,0.5075,0.233221,502,2688,3190,3190,0.275,0.5075,0.23322083333333332
345,2011-12-11,4,0,12,0,0,0,1,0.220833,0.253154,0.49,0.0665417,377,2366,2743,2743,0.22083333333333333,0.49,0.06654166666666667
346,2011-12-12,4,0,12,0,1,1,1,0.238333,0.270196,0.670833,0.06345,143,3167,3310,3310,0.2383333333333333,0.6708333333333334,0.06344999999999999
347,2011-12-13,4,0,12,0,2,1,1,0.2825,0.301138,0.59,0.14055,155,3368,3523,3523,0.28250000000000003,0.59,0.14055
348,2011-12-14,4,0,12,0,3,1,2,0.3175,0.338362,0.66375,0.0609583,178,3562,3740,3740,0.3175,0.66375,0.06095833333333334
349,2011-12-15,4,0,12,0,4,1,2,0.4225,0.412237,0.634167,0.268042,181,3528,3709,3709,0.42250000000000004,0.6341666666666667,0.2680416666666667
350,2011-12-16,4,0,12,0,5,1,2,0.375,0.359825,0.500417,0.260575,178,3399,3577,3577,0.375,0.5004166666666666,0.260575
351,2011-12-17,4,0,12,0,6,0,2,0.258333,0.249371,0.560833,0.243167,275,2464,2739,2739,0.25833333333333336,0.5608333333333334,0.24316666666666667
352,2011-12-18,4,0,12,0,0,0,1,0.238333,0.245579,0.58625,0.169779,220,2211,2431,2431,0.2383333333333333,0.58625,0.16977916666666668
353,2011-12-19,4,0,12,0,1,1,1,0.276667,0.280933,0.6375,0.172896,260,3143,3403,3403,0.27666666666666667,0.6375000000000001,0.17289583333333333
354,2011-12-20,4,0,12,0,2,1,2,0.385833,0.396454,0.595417,0.0615708,216,3534,3750,3750,0.3858333333333333,0.5954166666666667,0.06157083333333333
355,2011-12-21,1,0,12,0,3,1,2,0.428333,0.428017,0.858333,0.2214,107,2553,2660,2660,0.4283333333333333,0.8583333333333334,0.2214
356,2011-12-22,1,0,12,0,4,1,2,0.423333,0.426121,0.7575,0.047275,227,2841,3068,3068,0.42333333333333334,0.7575,0.047275000000000005
357,2011-12-23,1,0,12,0,5,1,1,0.373333,0.377513,0.68625,0.274246,163,2046,2209,2209,0.37333333333333335,0.6862499999999999,0.27424583333333336
358,2011-12-24,1,0,12,0,6,0,1,0.3025,0.299242,0.5425,0.190304,155,856,1011,1011,0.3025,0.5425,0.1903041666666667
359,2011-12-25,1,0,12,0,0,0,1,0.274783,0.279961,0.681304,0.155091,303,451,754,754,0.2747826086956522,0.681304347826087,0.1550913043478261
360,2011-12-26,1,0,12,1,1,0,1,0.321739,0.315535,0.506957,0.239465,430,887,1317,1317,0.32173913043478264,0.5069565217391304,0.23946521739130433
361,2011-12-27,1,0,12,0,2,1,2,0.325,0.327633,0.7625,0.18845,103,1059,1162,1162,0.325,0.7625000000000001,0.18845
362,2011-12-28,1,0,12,0,3,1,1,0.29913,0.279974,0.503913,0.293961,255,2047,2302,2302,0.2991304347826087,0.5039130434782608,0.2939608695652174
363,2011-12-29,1,0,12,0,4,1,1,0.248333,0.263892,0.574167,0.119412,254,2169,2423,2423,0.24833333333333332,0.5741666666666667,0.11941249999999999
364,2011-12-30,1,0,12,0,5,1,1,0.311667,0.318812,0.636667,0.134337,491,2508,2999,2999,0.3116666666666667,0.6366666666666666,0.1343375
365,2011-12-31,1,0,12,0,6,0,1,0.41,0.414121,0.615833,0.220154,665,1820,2485,2485,0.41,0.6158333333333333,0.22015416666666665
366,2012-01-01,1,1,1,0,0,0,1,0.37,0.375621,0.6925,0.192167,686,1608,2294,2294,0.37000000000000005,0.6925,0.19216666666666668
367,2012-01-02,1,1,1,1,1,0,1,0.273043,0.252304,0.381304,0.329665,244,1707,1951,1951,0.27304347826086955,0.38130434782608696,0.32966521739130433
368,2012-01-03,1,1,1,0,2,1,1,0.15,0.126275,0.44125,0.365671,89,2147,2236,2236,0.15,0.44125,0.36567083333333333
369,2012-01-04,1,1,1,0,3,1,2,0.1075,0.119337,0.414583,0.1847,95,2273,2368,2368,0.1075,0.4145833333333333,0.1847
370,2012-01-05,1,1,1,0,4,1,1,0.265833,0.278412,0.524167,0.129987,140,3132,3272,3272,0.2658333333333333,0.5241666666666667,0.1299875
371,2012-01-06,1,1,1,0,5,1,1,0.334167,0.340267,0.542083,0.167908,307,3791,4098,4098,0.33416666666666667,0.5420833333333334,0.16790833333333333
372,2012-01-07,1,1,1,0,6,0,1,0.393333,0.390779,0.531667,0.174758,1070,3451,4521,4521,0.3933333333333333,0.5316666666666666,0.17475833333333335
373,2012-01-08,1,1,1,0,0,0,1,0.3375,0.340258,0.465,0.191542,599,2826,3425,3425,0.33749999999999997,0.465,0.19154166666666664
374,2012-01-09,1,1,1,0,1,1,2,0.224167,0.247479,0.701667,0.0989,106,2270,2376,2376,0.22416666666666665,0.7016666666666667,0.0989
375,2012-01-10,1,1,1,0,2,1,1,0.308696,0.318826,0.646522,0.187552,173,3425,3598,3598,0.30869565217391304,0.6465217391304349,0.18755217391304346
376,2012-01-11,1,1,1,0,3,1,2,0.274167,0.282821,0.8475,0.131221,92,2085,2177,2177,0.27416666666666667,0.8475,0.13122083333333334
377,2012-01-12,1,1,1,0,4,1,2,0.3825,0.381938,0.802917,0.180967,269,3828,4097,4097,0.3825,0.8029166666666666,0.1809666666666667
378,2012-01-13,1,1,1,0,5,1,1,0.274167,0.249362,0.5075,0.378108,174,3040,3214,3214,0.27416666666666667,0.5075,0.3781083333333333
379,2012-01-14,1,1,1,0,6,0,1,0.18,0.183087,0.4575,0.187183,333,2160,2493,2493,0.18000000000000002,0.4575,0.18718333333333334
380,2012-01-15,1,1,1,0,0,0,1,0.166667,0.161625,0.419167,0.251258,284,2027,2311,2311,0.16666666666666666,0.4191666666666667,0.2512583333333333
381,2012-01-16,1,1,1,1,1,0,1,0.19,0.190663,0.5225,0.231358,217,2081,2298,2298,0.19000000000000003,0.5225,0.23135833333333333
382,2012-01-17,1,1,1,0,2,1,2,0.373043,0.364278,0.716087,0.34913,127,2808,2935,2935,0.3730434782608696,0.716086956521739,0.3491304347826087
383,2012-01-18,1,1,1,0,3,1,1,0.303333,0.275254,0.443333,0.415429,109,3267,3376,3376,0.30333333333333334,0.44333333333333336,0.4154291666666667
384,2012-01-19,1,1,1,0,4,1,1,0.19,0.190038,0.4975,0.220158,130,3162,3292,3292,0.19000000000000003,0.4975,0.22015833333333334
385,2012-01-20,1,1,1,0,5,1,2,0.2175,0.220958,0.45,0.20275,115,3048,3163,3163,0.2175,0.45,0.20274999999999999
386,2012-01-21,1,1,1,0,6,0,2,0.173333,0.174875,0.83125,0.222642,67,1234,1301,1301,0.17333333333333334,0.8312499999999999,0.22264166666666665
387,2012-01-22,1,1,1,0,0,0,2,0.1625,0.16225,0.79625,0.199638,196,1781,1977,1977,0.1625,0.79625,0.1996375
388,2012-01-23,1,1,1,0,1,1,2,0.218333,0.243058,0.91125,0.110708,145,2287,2432,2432,0.21833333333333335,0.91125,0.11070833333333334
389,2012-01-24,1,1,1,0,2,1,1,0.3425,0.349108,0.835833,0.123767,439,3900,4339,4339,0.3425,0.8358333333333333,0.12376666666666668
390,2012-01-25,1,1,1,0,3,1,1,0.294167,0.294821,0.64375,0.161071,467,3803,4270,4270,0.2941666666666667,0.6437499999999999,0.16107083333333333
391,2012-01-26,1,1,1,0,4,1,2,0.341667,0.35605,0.769583,0.0733958,244,3831,4075,4075,0.34166666666666673,0.7695833333333333,0.07339583333333334
392,2012-01-27,1,1,1,0,5,1,2,0.425,0.415383,0.74125,0.342667,269,3187,3456,3456,0.425,0.74125,0.3426666666666667
393,2012-01-28,1,1,1,0,6,0,1,0.315833,0.326379,0.543333,0.210829,775,3248,4023,4023,0.31583333333333335,0.5433333333333333,0.21082916666666665
394,2012-01-29,1,1,1,0,0,0,1,0.2825,0.272721,0.31125,0.24005,558,2685,3243,3243,0.28250000000000003,0.31125,0.24004999999999999
395,2012-01-30,1,1,1,0,1,1,1,0.269167,0.262625,0.400833,0.215792,126,3498,3624,3624,0.26916666666666667,0.4008333333333333,0.2157916666666667
396,2012-01-31,1,1,1,0,2,1,1,0.39,0.381317,0.416667,0.261817,324,4185,4509,4509,0.38999999999999996,0.4166666666666667,0.26181666666666664
397,2012-02-01,1,1,2,0,3,1,1,0.469167,0.466538,0.507917,0.189067,304,4275,4579,4579,0.4691666666666667,0.5079166666666667,0.1890666666666667
398,2012-02-02,1,1,2,0,4,1,2,0.399167,0.398971,0.672917,0.187187,190,3571,3761,3761,0.39916666666666667,0.6729166666666666,0.18718749999999998
399,2012-02-03,1,1,2,0,5,1,1,0.313333,0.309346,0.526667,0.178496,310,3841,4151,4151,0.31333333333333335,0.5266666666666667,0.17849583333333333
400,2012-02-04,1,1,2,0,6,0,2,0.264167,0.272725,0.779583,0.121896,384,2448,2832,2832,0.26416666666666666,0.7795833333333334,0.12189583333333333
401,2012-02-05,1,1,2,0,0,0,2,0.265833,0.264521,0.687917,0.175996,318,2629,2947,2947,0.2658333333333333,0.6879166666666667,0.17599583333333335
402,2012-02-06,1,1,2,0,1,1,1,0.282609,0.296426,0.622174,0.1538,206,3578,3784,3784,0.2826086956521739,0.6221739130434782,0.1538
403,2012-02-07,1,1,2,0,2,1,1,0.354167,0.361104,0.49625,0.147379,199,4176,4375,4375,0.3541666666666667,0.49625,0.14737916666666667
404,2012-02-08,1,1,2,0,3,1,2,0.256667,0.266421,0.722917,0.133721,109,2693,2802,2802,0.25666666666666665,0.7229166666666668,0.13372083333333332
405,2012-02-09,1,1,2,0,4,1,1,0.265,0.261988,0.562083,0.194037,163,3667,3830,3830,0.265,0.5620833333333334,0.1940375
406,2012-02-10,1,1,2,0,5,1,2,0.280833,0.293558,0.54,0.116929,227,3604,3831,3831,0.2808333333333333,0.54,0.11692916666666668
407,2012-02-11,1,1,2,0,6,0,3,0.224167,0.210867,0.73125,0.289796,192,1977,2169,2169,0.22416666666666665,0.7312500000000001,0.2897958333333333
408,2012-02-12,1,1,2,0,0,0,1,0.1275,0.101658,0.464583,0.409212,73,1456,1529,1529,0.1275,0.46458333333333335,0.4092125
409,2012-02-13,1,1,2,0,1,1,1,0.2225,0.227913,0.41125,0.167283,94,3328,3422,3422,0.2225,0.41125000000000006,0.16728333333333334
410,2012-02-14,1,1,2,0,2,1,2,0.319167,0.333946,0.50875,0.141179,135,3787,3922,3922,0.31916666666666665,0.50875,0.14117916666666666
411,2012-02-15,1,1,2,0,3,1,1,0.348333,0.351629,0.53125,0.1816,141,4028,4169,4169,0.34833333333333333,0.53125,0.1816
412,2012-02-16,1,1,2,0,4,1,2,0.316667,0.330162,0.752917,0.091425,74,2931,3005,3005,0.31666666666666665,0.7529166666666667,0.09142499999999999
413,2012-02-17,1,1,2,0,5,1,1,0.343333,0.351629,0.634583,0.205846,349,3805,4154,4154,0.3433333333333333,0.6345833333333334,0.2058458333333333
414,2012-02-18,1,1,2,0,6,0,1,0.346667,0.355425,0.534583,0.190929,1435,2883,4318,4318,0.3466666666666667,0.5345833333333333,0.19092916666666668
415,2012-02-19,1,1,2,0,0,0,2,0.28,0.265788,0.515833,0.253112,618,2071,2689,2689,0.27999999999999997,0.5158333333333334,0.2531125
416,2012-02-20,1,1,2,1,1,0,1,0.28,0.273391,0.507826,0.229083,502,2627,3129,3129,0.28,0.5078260869565218,0.2290826086956522
417,2012-02-21,1,1,2,0,2,1,1,0.287826,0.295113,0.594348,0.205717,163,3614,3777,3777,0.28782608695652173,0.5943478260869565,0.2057173913043478
418,2012-02-22,1,1,2,0,3,1,1,0.395833,0.392667,0.567917,0.234471,394,4379,4773,4773,0.3958333333333333,0.5679166666666666,0.23447083333333332
419,2012-02-23,1,1,2,0,4,1,1,0.454167,0.444446,0.554583,0.190913,516,4546,5062,5062,0.45416666666666666,0.5545833333333333,0.1909125
420,2012-02-24,1,1,2,0,5,1,2,0.4075,0.410971,0.7375,0.237567,246,3241,3487,3487,0.4075,0.7374999999999999,0.23756666666666668
421,2012-02-25,1,1,2,0,6,0,1,0.290833,0.255675,0.395833,0.421642,317,2415,2732,2732,0.29083333333333333,0.3958333333333333,0.4216416666666667
422,2012-02-26,1,1,2,0,0,0,1,0.279167,0.268308,0.41,0.205229,515,2874,3389,3389,0.2791666666666667,0.41,0.20522916666666668
423,2012-02-27,1,1,2,0,1,1,1,0.366667,0.357954,0.490833,0.268033,253,4069,4322,4322,0.3666666666666667,0.4908333333333333,0.26803333333333335
424,2012-02-28,1,1,2,0,2,1,1,0.359167,0.353525,0.395833,0.193417,229,4134,4363,4363,0.3591666666666667,0.3958333333333333,0.19341666666666668
425,2012-02-29,1,1,2,0,3,1,2,0.344348,0.34847,0.804783,0.179117,65,1769,1834,1834,0.3443478260869565,0.8047826086956522,0.1791173913043478
426,2012-03-01,1,1,3,0,4,1,1,0.485833,0.475371,0.615417,0.226987,325,4665,4990,4990,0.48583333333333334,0.6154166666666666,0.2269875
427,2012-03-02,1,1,3,0,5,1,2,0.353333,0.359842,0.657083,0.144904,246,2948,3194,3194,0.35333333333333333,0.6570833333333334,0.14490416666666667
428,2012-03-03,1,1,3,0,6,0,2,0.414167,0.413492,0.62125,0.161079,956,3110,4066,4066,0.4141666666666666,0.62125,0.16107916666666666
429,2012-03-04,1,1,3,0,0,0,1,0.325833,0.303021,0.403333,0.334571,710,2713,3423,3423,0.32583333333333336,0.4033333333333333,0.3345708333333333
430,2012-03-05,1,1,3,0,1,1,1,0.243333,0.241171,0.50625,0.228858,203,3130,3333,3333,0.24333333333333332,0.50625,0.2288583333333333
431,2012-03-06,1,1,3,0,2,1,1,0.258333,0.255042,0.456667,0.200875,221,3735,3956,3956,0.25833333333333336,0.4566666666666667,0.200875
432,2012-03-07,1,1,3,0,3,1,1,0.404167,0.3851,0.513333,0.345779,432,4484,4916,4916,0.40416666666666673,0.5133333333333333,0.3457791666666667
433,2012-03-08,1,1,3,0,4,1,1,0.5275,0.524604,0.5675,0.441563,486,4896,5382,5382,0.5275,0.5675,0.4415625
434,2012-03-09,1,1,3,0,5,1,2,0.410833,0.397083,0.407083,0.4148,447,4122,4569,4569,0.41083333333333333,0.4070833333333333,0.4148
435,2012-03-10,1,1,3,0,6,0,1,0.2875,0.277767,0.350417,0.22575,968,3150,4118,4118,0.28750000000000003,0.35041666666666665,0.22575
436,2012-03-11,1,1,3,0,0,0,1,0.361739,0.35967,0.476957,0.222587,1658,3253,4911,4911,0.3617391304347826,0.4769565217391304,0.22258695652173915
437,2012-03-12,1,1,3,0,1,1,1,0.466667,0.459592,0.489167,0.207713,838,4460,5298,5298,0.46666666666666673,0.4891666666666667,0.2077125
438,2012-03-13,1,1,3,0,2,1,1,0.565,0.542929,0.6175,0.23695,762,5085,5847,5847,0.5650000000000001,0.6175,0.23695
439,2012-03-14,1,1,3,0,3,1,1,0.5725,0.548617,0.507083,0.115062,997,5315,6312,6312,0.5725,0.5070833333333333,0.1150625
440,2012-03-15,1,1,3,0,4,1,1,0.5575,0.532825,0.579583,0.149883,1005,5187,6192,6192,0.5575,0.5795833333333333,0.14988333333333334
441,2012-03-16,1,1,3,0,5,1,2,0.435833,0.436229,0.842083,0.113192,548,3830,4378,4378,0.43583333333333335,0.8420833333333334,0.11319166666666668
442,2012-03-17,1,1,3,0,6,0,2,0.514167,0.505046,0.755833,0.110704,3155,4681,7836,7836,0.5141666666666667,0.7558333333333334,0.11070416666666667
443,2012-03-18,1,1,3,0,0,0,2,0.4725,0.464,0.81,0.126883,2207,3685,5892,5892,0.4725,0.81,0.12688333333333332
444,2012-03-19,1,1,3,0,1,1,1,0.545,0.532821,0.72875,0.162317,982,5171,6153,6153,0.545,0.7287499999999999,0.16231666666666666
445,2012-03-20,1,1,3,0,2,1,1,0.560833,0.538533,0.807917,0.121271,1051,5042,6093,6093,0.5608333333333334,0.8079166666666667,0.12127083333333333
446,2012-03-21,2,1,3,0,3,1,2,0.531667,0.513258,0.82125,0.0895583,1122,5108,6230,6230,0.5316666666666666,0.82125,0.08955833333333334
447,2012-03-22,2,1,3,0,4,1,1,0.554167,0.531567,0.83125,0.117562,1334,5537,6871,6871,0.5541666666666667,0.8312499999999999,0.1175625
448,2012-03-23,2,1,3,0,5,1,2,0.601667,0.570067,0.694167,0.1163,2469,5893,8362,8362,0.6016666666666667,0.6941666666666667,0.1163
449,2012-03-24,2,1,3,0,6,0,2,0.5025,0.486733,0.885417,0.192783,1033,2339,3372,3372,0.5025000000000001,0.8854166666666666,0.19278333333333333
450,2012-03-25,2,1,3,0,0,0,2,0.4375,0.437488,0.880833,0.220775,1532,3464,4996,4996,0.4375,0.8808333333333334,0.22077500000000003
451,2012-03-26,2,1,3,0,1,1,1,0.445833,0.43875,0.477917,0.386821,795,4763,5558,5558,0.4458333333333333,0.4779166666666666,0.38682083333333334
452,2012-03-27,2,1,3,0,2,1,1,0.323333,0.315654,0.29,0.187192,531,4571,5102,5102,0.3233333333333333,0.29,0.18719166666666667
453,2012-03-28,2,1,3,0,3,1,1,0.484167,0.47095,0.48125,0.291671,674,5024,5698,5698,0.4841666666666667,0.48125,0.2916708333333333
454,2012-03-29,2,1,3,0,4,1,1,0.494167,0.482304,0.439167,0.31965,834,5299,6133,6133,0.49416666666666664,0.43916666666666665,0.31965
455,2012-03-30,2,1,3,0,5,1,2,0.37,0.375621,0.580833,0.138067,796,4663,5459,5459,0.37000000000000005,0.5808333333333333,0.13806666666666667
456,2012-03-31,2,1,3,0,6,0,2,0.424167,0.421708,0.738333,0.250617,2301,3934,6235,6235,0.42416666666666664,0.7383333333333333,0.25061666666666665
457,2012-04-01,2,1,4,0,0,0,2,0.425833,0.417287,0.67625,0.172267,2347,3694,6041,6041,0.42583333333333334,0.67625,0.17226666666666668
458,2012-04-02,2,1,4,0,1,1,1,0.433913,0.427513,0.504348,0.312139,1208,4728,5936,5936,0.4339130434782609,0.5043478260869565,0.3121391304347826
459,2012-04-03,2,1,4,0,2,1,1,0.466667,0.461483,0.396667,0.100133,1348,5424,6772,6772,0.4666666666666666,0.39666666666666667,0.10013333333333334
460,2012-04-04,2,1,4,0,3,1,1,0.541667,0.53345,0.469583,0.180975,1058,5378,6436,6436,0.5416666666666666,0.4695833333333333,0.180975
461,2012-04-05,2,1,4,0,4,1,1,0.435,0.431163,0.374167,0.219529,1192,5265,6457,6457,0.435,0.3741666666666667,0.21952916666666666
462,2012-04-06,2,1,4,0,5,1,1,0.403333,0.390767,0.377083,0.300388,1807,4653,6460,6460,0.4033333333333333,0.3770833333333334,0.3003875
463,2012-04-07,2,1,4,0,6,0,1,0.4375,0.426129,0.254167,0.274871,3252,3605,6857,6857,0.4375,0.2541666666666667,0.27487083333333334
464,2012-04-08,2,1,4,0,0,0,1,0.5,0.492425,0.275833,0.232596,2230,2939,5169,5169,0.5,0.2758333333333333,0.23259583333333333
465,2012-04-09,2,1,4,0,1,1,1,0.489167,0.476638,0.3175,0.358196,905,4680,5585,5585,0.4891666666666667,0.3175,0.3581958333333333
466,2012-04-10,2,1,4,0,2,1,1,0.446667,0.436233,0.435,0.249375,819,5099,5918,5918,0.4466666666666667,0.435,0.249375
467,2012-04-11,2,1,4,0,3,1,1,0.348696,0.337274,0.469565,0.295274,482,4380,4862,4862,0.348695652173913,0.46956521739130436,0.2952739130434782
468,2012-04-12,2,1,4,0,4,1,1,0.3975,0.387604,0.46625,0.290429,663,4746,5409,5409,0.39749999999999996,0.46625,0.2904291666666667
469,2012-04-13,2,1,4,0,5,1,1,0.4425,0.431808,0.408333,0.155471,1252,5146,6398,6398,0.44250000000000006,0.4083333333333334,0.15547083333333334
470,2012-04-14,2,1,4,0,6,0,1,0.495,0.487996,0.502917,0.190917,2795,4665,7460,7460,0.49500000000000005,0.5029166666666667,0.19091666666666665
471,2012-04-15,2,1,4,0,0,0,1,0.606667,0.573875,0.507917,0.225129,2846,4286,7132,7132,0.6066666666666667,0.5079166666666667,0.22512916666666669
472,2012-04-16,2,1,4,1,1,0,1,0.664167,0.614925,0.561667,0.284829,1198,5172,6370,6370,0.6641666666666667,0.5616666666666666,0.28482916666666663
473,2012-04-17,2,1,4,0,2,1,1,0.608333,0.598487,0.390417,0.273629,989,5702,6691,6691,0.6083333333333333,0.39041666666666663,0.27362916666666665
474,2012-04-18,2,1,4,0,3,1,2,0.463333,0.457038,0.569167,0.167912,347,4020,4367,4367,0.4633333333333333,0.5691666666666667,0.1679125
475,2012-04-19,2,1,4,0,4,1,1,0.498333,0.493046,0.6125,0.0659292,846,5719,6565,6565,0.49833333333333335,0.6124999999999999,0.06592916666666666
476,2012-04-20,2,1,4,0,5,1,1,0.526667,0.515775,0.694583,0.149871,1340,5950,7290,7290,0.5266666666666667,0.6945833333333334,0.14987083333333334
477,2012-04-21,2,1,4,0,6,0,1,0.57,0.542921,0.682917,0.283587,2541,4083,6624,6624,0.57,0.6829166666666667,0.2835875
478,2012-04-22,2,1,4,0,0,0,3,0.396667,0.389504,0.835417,0.344546,120,907,1027,1027,0.39666666666666667,0.8354166666666667,0.34454583333333333
479,2012-04-23,2,1,4,0,1,1,2,0.321667,0.301125,0.766667,0.303496,195,3019,3214,3214,0.32166666666666666,0.7666666666666666,0.30349583333333335
480,2012-04-24,2,1,4,0,2,1,1,0.413333,0.405283,0.454167,0.249383,518,5115,5633,5633,0.41333333333333333,0.45416666666666666,0.24938333333333332
481,2012-04-25,2,1,4,0,3,1,1,0.476667,0.470317,0.427917,0.118792,655,5541,6196,6196,0.4766666666666666,0.42791666666666667,0.11879166666666667
482,2012-04-26,2,1,4,0,4,1,2,0.498333,0.483583,0.756667,0.176625,475,4551,5026,5026,0.49833333333333335,0.7566666666666667,0.176625
483,2012-04-27,2,1,4,0,5,1,1,0.4575,0.452637,0.400833,0.347633,1014,5219,6233,6233,0.4575,0.4008333333333333,0.3476333333333333
484,2012-04-28,2,1,4,0,6,0,2,0.376667,0.377504,0.489583,0.129975,1120,3100,4220,4220,0.3766666666666667,0.4895833333333333,0.129975
485,2012-04-29,2,1,4,0,0,0,1,0.458333,0.450121,0.587083,0.116908,2229,4075,6304,6304,0.4583333333333333,0.5870833333333333,0.11690833333333334
486,2012-04-30,2,1,4,0,1,1,2,0.464167,0.457696,0.57,0.171638,665,4907,5572,5572,0.46416666666666667,0.57,0.1716375
487,2012-05-01,2,1,5,0,2,1,2,0.613333,0.577021,0.659583,0.156096,653,5087,5740,5740,0.6133333333333334,0.6595833333333333,0.15609583333333332
488,2012-05-02,2,1,5,0,3,1,1,0.564167,0.537896,0.797083,0.138058,667,5502,6169,6169,0.5641666666666667,0.7970833333333333,0.1380583333333333
489,2012-05-03,2,1,5,0,4,1,2,0.56,0.537242,0.768333,0.133696,764,5657,6421,6421,0.5599999999999999,0.7683333333333334,0.13369583333333332
490,2012-05-04,2,1,5,0,5,1,1,0.6275,0.590917,0.735417,0.162938,1069,5227,6296,6296,0.6275000000000001,0.7354166666666666,0.1629375
491,2012-05-05,2,1,5,0,6,0,2,0.621667,0.584608,0.756667,0.152992,2496,4387,6883,6883,0.6216666666666667,0.7566666666666667,0.15299166666666666
492,2012-05-06,2,1,5,0,0,0,2,0.5625,0.546737,0.74,0.149879,2135,4224,6359,6359,0.5625,0.7399999999999999,0.14987916666666667
493,2012-05-07,2,1,5,0,1,1,2,0.5375,0.527142,0.664167,0.230721,1008,5265,6273,6273,0.5375,0.6641666666666667,0.23072083333333335
494,2012-05-08,2,1,5,0,2,1,2,0.581667,0.557471,0.685833,0.296029,738,4990,5728,5728,0.5816666666666667,0.6858333333333334,0.2960291666666667
495,2012-05-09,2,1,5,0,3,1,2,0.575,0.553025,0.744167,0.216412,620,4097,4717,4717,0.5750000000000001,0.7441666666666666,0.2164125
496,2012-05-10,2,1,5,0,4,1,1,0.505833,0.491783,0.552083,0.314063,1026,5546,6572,6572,0.5058333333333334,0.5520833333333334,0.31406249999999997
497,2012-05-11,2,1,5,0,5,1,1,0.533333,0.520833,0.360417,0.236937,1319,5711,7030,7030,0.5333333333333333,0.36041666666666666,0.2369375
498,2012-05-12,2,1,5,0,6,0,1,0.564167,0.544817,0.480417,0.123133,2622,4807,7429,7429,0.5641666666666667,0.48041666666666666,0.12313333333333333
499,2012-05-13,2,1,5,0,0,0,1,0.6125,0.585238,0.57625,0.225117,2172,3946,6118,6118,0.6125,0.57625,0.22511666666666666
500,2012-05-14,2,1,5,0,1,1,2,0.573333,0.5499,0.789583,0.212692,342,2501,2843,2843,0.5733333333333334,0.7895833333333333,0.21269166666666664
501,2012-05-15,2,1,5,0,2,1,2,0.611667,0.576404,0.794583,0.147392,625,4490,5115,5115,0.6116666666666667,0.7945833333333333,0.14739166666666667
502,2012-05-16,2,1,5,0,3,1,1,0.636667,0.595975,0.697917,0.122512,991,6433,7424,7424,0.6366666666666666,0.6979166666666666,0.12251250000000001
503,2012-05-17,2,1,5,0,4,1,1,0.593333,0.572613,0.52,0.229475,1242,6142,7384,7384,0.5933333333333334,0.52,0.229475
504,2012-05-18,2,1,5,0,5,1,1,0.564167,0.551121,0.523333,0.136817,1521,6118,7639,7639,0.5641666666666667,0.5233333333333333,0.13681666666666667
505,2012-05-19,2,1,5,0,6,0,1,0.6,0.566908,0.45625,0.083975,3410,4884,8294,8294,0.6,0.45625,0.08397500000000001
506,2012-05-20,2,1,5,0,0,0,1,0.620833,0.583967,0.530417,0.254367,2704,4425,7129,7129,0.6208333333333333,0.5304166666666666,0.2543666666666667
507,2012-05-21,2,1,5,0,1,1,2,0.598333,0.565667,0.81125,0.233204,630,3729,4359,4359,0.5983333333333333,0.8112499999999999,0.23320416666666666
508,2012-05-22,2,1,5,0,2,1,2,0.615,0.580825,0.765833,0.118167,819,5254,6073,6073,0.615,0.7658333333333333,0.11816666666666666
509,2012-05-23,2,1,5,0,3,1,2,0.621667,0.584612,0.774583,0.102,766,4494,5260,5260,0.6216666666666667,0.7745833333333333,0.102
510,2012-05-24,2,1,5,0,4,1,1,0.655,0.6067,0.716667,0.172896,1059,5711,6770,6770,0.6549999999999999,0.7166666666666667,0.17289583333333333
511,2012-05-25,2,1,5,0,5,1,1,0.68,0.627529,0.747083,0.14055,1417,5317,6734,6734,0.68,0.7470833333333333,0.14054999999999998
512,2012-05-26,2,1,5,0,6,0,1,0.6925,0.642696,0.7325,0.198992,2855,3681,6536,6536,0.6925,0.7325,0.19899166666666668
513,2012-05-27,2,1,5,0,0,0,1,0.69,0.641425,0.697083,0.215171,3283,3308,6591,6591,0.69,0.6970833333333334,0.21517083333333334
514,2012-05-28,2,1,5,1,1,0,1,0.7125,0.6793,0.67625,0.196521,2557,3486,6043,6043,0.7125,0.67625,0.19652083333333334
515,2012-05-29,2,1,5,0,2,1,1,0.7225,0.672992,0.684583,0.2954,880,4863,5743,5743,0.7225,0.6845833333333333,0.2954
516,2012-05-30,2,1,5,0,3,1,2,0.656667,0.611129,0.67,0.134329,745,6110,6855,6855,0.6566666666666666,0.6699999999999999,0.13432916666666667
517,2012-05-31,2,1,5,0,4,1,1,0.68,0.631329,0.492917,0.195279,1100,6238,7338,7338,0.68,0.49291666666666667,0.19527916666666667
518,2012-06-01,2,1,6,0,5,1,2,0.654167,0.607962,0.755417,0.237563,533,3594,4127,4127,0.6541666666666667,0.7554166666666666,0.2375625
519,2012-06-02,2,1,6,0,6,0,1,0.583333,0.566288,0.549167,0.186562,2795,5325,8120,8120,0.5833333333333334,0.5491666666666667,0.1865625
520,2012-06-03,2,1,6,0,0,0,1,0.6025,0.575133,0.493333,0.184087,2494,5147,7641,7641,0.6025,0.49333333333333335,0.1840875
521,2012-06-04,2,1,6,0,1,1,1,0.5975,0.578283,0.487083,0.284833,1071,5927,6998,6998,0.5975,0.4870833333333333,0.2848333333333333
522,2012-06-05,2,1,6,0,2,1,2,0.540833,0.525892,0.613333,0.209575,968,6033,7001,7001,0.5408333333333334,0.6133333333333334,0.20957499999999998
523,2012-06-06,2,1,6,0,3,1,1,0.554167,0.542292,0.61125,0.077125,1027,6028,7055,7055,0.5541666666666667,0.61125,0.077125
524,2012-06-07,2,1,6,0,4,1,1,0.6025,0.569442,0.567083,0.15735,1038,6456,7494,7494,0.6024999999999999,0.5670833333333333,0.15735000000000002
525,2012-06-08,2,1,6,0,5,1,1,0.649167,0.597862,0.467917,0.175383,1488,6248,7736,7736,0.6491666666666667,0.4679166666666667,0.17538333333333334
526,2012-06-09,2,1,6,0,6,0,1,0.710833,0.648367,0.437083,0.144287,2708,4790,7498,7498,0.7108333333333333,0.4370833333333333,0.14428749999999999
527,2012-06-10,2,1,6,0,0,0,1,0.726667,0.663517,0.538333,0.133721,2224,4374,6598,6598,0.7266666666666667,0.5383333333333333,0.13372083333333332
528,2012-06-11,2,1,6,0,1,1,2,0.720833,0.659721,0.587917,0.207713,1017,5647,6664,6664,0.7208333333333333,0.5879166666666666,0.2077125
529,2012-06-12,2,1,6,0,2,1,2,0.653333,0.597875,0.833333,0.214546,477,4495,4972,4972,0.6533333333333333,0.8333333333333334,0.21454583333333332
530,2012-06-13,2,1,6,0,3,1,1,0.655833,0.611117,0.582083,0.343279,1173,6248,7421,7421,0.6558333333333334,0.5820833333333333,0.34327916666666664
531,2012-06-14,2,1,6,0,4,1,1,0.648333,0.624383,0.569583,0.253733,1180,6183,7363,7363,0.6483333333333333,0.5695833333333333,0.2537333333333333
532,2012-06-15,2,1,6,0,5,1,1,0.639167,0.599754,0.589583,0.176617,1563,6102,7665,7665,0.6391666666666667,0.5895833333333333,0.17661666666666667
533,2012-06-16,2,1,6,0,6,0,1,0.631667,0.594708,0.504167,0.166667,2963,4739,7702,7702,0.6316666666666667,0.5041666666666667,0.16666666666666666
534,2012-06-17,2,1,6,0,0,0,1,0.5925,0.571975,0.59875,0.144904,2634,4344,6978,6978,0.5925,0.59875,0.14490416666666667
535,2012-06-18,2,1,6,0,1,1,2,0.568333,0.544842,0.777917,0.174746,653,4446,5099,5099,0.5683333333333334,0.7779166666666666,0.17474583333333335
536,2012-06-19,2,1,6,0,2,1,1,0.688333,0.654692,0.69,0.148017,968,5857,6825,6825,0.6883333333333334,0.69,0.14801666666666666
537,2012-06-20,2,1,6,0,3,1,1,0.7825,0.720975,0.592083,0.113812,872,5339,6211,6211,0.7825000000000001,0.5920833333333334,0.1138125
538,2012-06-21,3,1,6,0,4,1,1,0.805833,0.752542,0.567917,0.118787,778,5127,5905,5905,0.8058333333333333,0.5679166666666666,0.1187875
539,2012-06-22,3,1,6,0,5,1,1,0.7775,0.724121,0.57375,0.182842,964,4859,5823,5823,0.7775,0.57375,0.18284166666666668
540,2012-06-23,3,1,6,0,6,0,1,0.731667,0.652792,0.534583,0.179721,2657,4801,7458,7458,0.7316666666666666,0.5345833333333333,0.17972083333333333
541,2012-06-24,3,1,6,0,0,0,1,0.743333,0.674254,0.479167,0.145525,2551,4340,6891,6891,0.7433333333333333,0.4791666666666667,0.145525
542,2012-06-25,3,1,6,0,1,1,1,0.715833,0.654042,0.504167,0.300383,1139,5640,6779,6779,0.7158333333333333,0.5041666666666667,0.30038333333333334
543,2012-06-26,3,1,6,0,2,1,1,0.630833,0.594704,0.373333,0.347642,1077,6365,7442,7442,0.6308333333333334,0.37333333333333335,0.3476416666666667
544,2012-06-27,3,1,6,0,3,1,1,0.6975,0.640792,0.36,0.271775,1077,6258,7335,7335,0.6974999999999999,0.36000000000000004,0.27177500000000004
545,2012-06-28,3,1,6,0,4,1,1,0.749167,0.675512,0.4225,0.17165,921,5958,6879,6879,0.7491666666666666,0.42250000000000004,0.17165
546,2012-06-29,3,1,6,0,5,1,1,0.834167,0.786613,0.48875,0.165417,829,4634,5463,5463,0.8341666666666666,0.48875,0.16541666666666668
547,2012-06-30,3,1,6,0,6,0,1,0.765,0.687508,0.60125,0.161071,1455,4232,5687,5687,0.765,0.60125,0.16107083333333333
548,2012-07-01,3,1,7,0,0,0,1,0.815833,0.750629,0.51875,0.168529,1421,4110,5531,5531,0.8158333333333333,0.5187499999999999,0.16852916666666665
549,2012-07-02,3,1,7,0,1,1,1,0.781667,0.702038,0.447083,0.195267,904,5323,6227,6227,0.7816666666666666,0.44708333333333333,0.19526666666666667
550,2012-07-03,3,1,7,0,2,1,1,0.780833,0.70265,0.492083,0.126237,1052,5608,6660,6660,0.7808333333333333,0.4920833333333334,0.1262375
551,2012-07-04,3,1,7,1,3,0,1,0.789167,0.732337,0.53875,0.13495,2562,4841,7403,7403,0.7891666666666667,0.53875,0.13495
552,2012-07-05,3,1,7,0,4,1,1,0.8275,0.761367,0.457917,0.194029,1405,4836,6241,6241,0.8275,0.4579166666666667,0.19402916666666667
553,2012-07-06,3,1,7,0,5,1,1,0.828333,0.752533,0.450833,0.146142,1366,4841,6207,6207,0.8283333333333333,0.45083333333333336,0.14614166666666667
554,2012-07-07,3,1,7,0,6,0,1,0.861667,0.804913,0.492083,0.163554,1448,3392,4840,4840,0.8616666666666667,0.4920833333333334,0.16355416666666667
555,2012-07-08,3,1,7,0,0,0,1,0.8225,0.790396,0.57375,0.125629,1203,3469,4672,4672,0.8225000000000001,0.57375,0.12562916666666665
556,2012-07-09,3,1,7,0,1,1,2,0.710833,0.654054,0.683333,0.180975,998,5571,6569,6569,0.7108333333333333,0.6833333333333332,0.180975
557,2012-07-10,3,1,7,0,2,1,2,0.720833,0.664796,0.6675,0.151737,954,5336,6290,6290,0.7208333333333333,0.6675,0.1517375
558,2012-07-11,3,1,7,0,3,1,1,0.716667,0.650271,0.633333,0.151733,975,6289,7264,7264,0.7166666666666667,0.6333333333333333,0.15173333333333333
559,2012-07-12,3,1,7,0,4,1,1,0.715833,0.654683,0.529583,0.146775,1032,6414,7446,7446,0.7158333333333333,0.5295833333333333,0.14677500000000002
560,2012-07-13,3,1,7,0,5,1,2,0.731667,0.667933,0.485833,0.08085,1511,5988,7499,7499,0.7316666666666666,0.48583333333333334,0.08084999999999999
561,2012-07-14,3,1,7,0,6,0,2,0.703333,0.666042,0.699167,0.143679,2355,4614,6969,6969,0.7033333333333333,0.6991666666666667,0.14367916666666666
562,2012-07-15,3,1,7,0,0,0,1,0.745833,0.705196,0.717917,0.166667,1920,4111,6031,6031,0.7458333333333332,0.7179166666666666,0.16666666666666666
563,2012-07-16,3,1,7,0,1,1,1,0.763333,0.724125,0.645,0.164187,1088,5742,6830,6830,0.7633333333333333,0.645,0.1641875
564,2012-07-17,3,1,7,0,2,1,1,0.818333,0.755683,0.505833,0.114429,921,5865,6786,6786,0.8183333333333334,0.5058333333333334,0.11442916666666668
565,2012-07-18,3,1,7,0,3,1,1,0.793333,0.745583,0.577083,0.137442,799,4914,5713,5713,0.7933333333333333,0.5770833333333333,0.13744166666666666
566,2012-07-19,3,1,7,0,4,1,1,0.77,0.714642,0.600417,0.165429,888,5703,6591,6591,0.77,0.6004166666666667,0.16542916666666665
567,2012-07-20,3,1,7,0,5,1,2,0.665833,0.613025,0.844167,0.208967,747,5123,5870,5870,0.6658333333333334,0.8441666666666666,0.20896666666666666
568,2012-07-21,3,1,7,0,6,0,3,0.595833,0.549912,0.865417,0.2133,1264,3195,4459,4459,0.5958333333333333,0.8654166666666666,0.21330000000000002
569,2012-07-22,3,1,7,0,0,0,2,0.6675,0.623125,0.7625,0.0939208,2544,4866,7410,7410,0.6675,0.7625000000000001,0.09392083333333334
570,2012-07-23,3,1,7,0,1,1,1,0.741667,0.690017,0.694167,0.138683,1135,5831,6966,6966,0.7416666666666667,0.6941666666666667,0.13868333333333335
571,2012-07-24,3,1,7,0,2,1,1,0.750833,0.70645,0.655,0.211454,1140,6452,7592,7592,0.7508333333333334,0.655,0.2114541666666667
572,2012-07-25,3,1,7,0,3,1,1,0.724167,0.654054,0.45,0.1648,1383,6790,8173,8173,0.7241666666666666,0.45,0.1648
573,2012-07-26,3,1,7,0,4,1,1,0.776667,0.739263,0.596667,0.284813,1036,5825,6861,6861,0.7766666666666667,0.5966666666666667,0.28481249999999997
574,2012-07-27,3,1,7,0,5,1,1,0.781667,0.734217,0.594583,0.152992,1259,5645,6904,6904,0.7816666666666666,0.5945833333333334,0.15299166666666666
575,2012-07-28,3,1,7,0,6,0,1,0.755833,0.697604,0.613333,0.15735,2234,4451,6685,6685,0.7558333333333334,0.6133333333333333,0.15735000000000002
576,2012-07-29,3,1,7,0,0,0,1,0.721667,0.667933,0.62375,0.170396,2153,4444,6597,6597,0.7216666666666667,0.62375,0.17039583333333333
577,2012-07-30,3,1,7,0,1,1,1,0.730833,0.684987,0.66875,0.153617,1040,6065,7105,7105,0.7308333333333333,0.6687500000000001,0.15361666666666665
578,2012-07-31,3,1,7,0,2,1,1,0.713333,0.662896,0.704167,0.165425,968,6248,7216,7216,0.7133333333333334,0.7041666666666666,0.16542500000000002
579,2012-08-01,3,1,8,0,3,1,1,0.7175,0.667308,0.6775,0.141179,1074,6506,7580,7580,0.7174999999999999,0.6775000000000001,0.14117916666666666
580,2012-08-02,3,1,8,0,4,1,1,0.7525,0.707088,0.659583,0.129354,983,6278,7261,7261,0.7525,0.6595833333333333,0.12935416666666666
581,2012-08-03,3,1,8,0,5,1,2,0.765833,0.722867,0.6425,0.215792,1328,5847,7175,7175,0.7658333333333333,0.6425,0.2157916666666667
582,2012-08-04,3,1,8,0,6,0,1,0.793333,0.751267,0.613333,0.257458,2345,4479,6824,6824,0.7933333333333333,0.6133333333333334,0.25745833333333334
583,2012-08-05,3,1,8,0,0,0,1,0.769167,0.731079,0.6525,0.290421,1707,3757,5464,5464,0.7691666666666667,0.6525,0.2904208333333333
584,2012-08-06,3,1,8,0,1,1,2,0.7525,0.710246,0.654167,0.129354,1233,5780,7013,7013,0.7525,0.6541666666666667,0.12935416666666666
585,2012-08-07,3,1,8,0,2,1,2,0.735833,0.697621,0.70375,0.116908,1278,5995,7273,7273,0.7358333333333333,0.70375,0.11690833333333334
586,2012-08-08,3,1,8,0,3,1,2,0.75,0.707717,0.672917,0.1107,1263,6271,7534,7534,0.75,0.6729166666666666,0.1107
587,2012-08-09,3,1,8,0,4,1,1,0.755833,0.699508,0.620417,0.1561,1196,6090,7286,7286,0.7558333333333334,0.6204166666666667,0.1561
588,2012-08-10,3,1,8,0,5,1,2,0.715833,0.667942,0.715833,0.238813,1065,4721,5786,5786,0.7158333333333333,0.7158333333333333,0.2388125
589,2012-08-11,3,1,8,0,6,0,2,0.6925,0.638267,0.732917,0.206479,2247,4052,6299,6299,0.6925,0.7329166666666667,0.20647916666666666
590,2012-08-12,3,1,8,0,0,0,1,0.700833,0.644579,0.530417,0.122512,2182,4362,6544,6544,0.7008333333333333,0.5304166666666666,0.12251250000000001
591,2012-08-13,3,1,8,0,1,1,1,0.720833,0.662254,0.545417,0.136212,1207,5676,6883,6883,0.7208333333333333,0.5454166666666667,0.1362125
592,2012-08-14,3,1,8,0,2,1,1,0.726667,0.676779,0.686667,0.169158,1128,5656,6784,6784,0.7266666666666667,0.6866666666666666,0.16915833333333333
593,2012-08-15,3,1,8,0,3,1,1,0.706667,0.654037,0.619583,0.169771,1198,6149,7347,7347,0.7066666666666667,0.6195833333333333,0.16977083333333334
594,2012-08-16,3,1,8,0,4,1,1,0.719167,0.654688,0.519167,0.141796,1338,6267,7605,7605,0.7191666666666667,0.5191666666666667,0.14179583333333332
595,2012-08-17,3,1,8,0,5,1,1,0.723333,0.2424,0.570833,0.231354,1483,5665,7148,7148,0.7233333333333333,0.5708333333333333,0.23135416666666667
596,2012-08-18,3,1,8,0,6,0,1,0.678333,0.618071,0.603333,0.177867,2827,5038,7865,7865,0.6783333333333333,0.6033333333333334,0.17786666666666665
597,2012-08-19,3,1,8,0,0,0,2,0.635833,0.603554,0.711667,0.08645,1208,3341,4549,4549,0.6358333333333334,0.7116666666666666,0.08645000000000001
598,2012-08-20,3,1,8,0,1,1,2,0.635833,0.595967,0.734167,0.129979,1026,5504,6530,6530,0.6358333333333334,0.7341666666666667,0.12997916666666667
599,2012-08-21,3,1,8,0,2,1,1,0.649167,0.601025,0.67375,0.0727708,1081,5925,7006,7006,0.6491666666666667,0.67375,0.07277083333333334
600,2012-08-22,3,1,8,0,3,1,1,0.6675,0.621854,0.677083,0.0702833,1094,6281,7375,7375,0.6675,0.6770833333333334,0.07028333333333332
601,2012-08-23,3,1,8,0,4,1,1,0.695833,0.637008,0.635833,0.0845958,1363,6402,7765,7765,0.6958333333333333,0.6358333333333334,0.08459583333333333
602,2012-08-24,3,1,8,0,5,1,2,0.7025,0.6471,0.615,0.0721458,1325,6257,7582,7582,0.7025,0.615,0.07214583333333334
603,2012-08-25,3,1,8,0,6,0,2,0.661667,0.618696,0.712917,0.244408,1829,4224,6053,6053,0.6616666666666667,0.7129166666666666,0.24440833333333334
604,2012-08-26,3,1,8,0,0,0,2,0.653333,0.595996,0.845833,0.228858,1483,3772,5255,5255,0.6533333333333333,0.8458333333333333,0.22885833333333336
605,2012-08-27,3,1,8,0,1,1,1,0.703333,0.654688,0.730417,0.128733,989,5928,6917,6917,0.7033333333333333,0.7304166666666667,0.12873333333333334
606,2012-08-28,3,1,8,0,2,1,1,0.728333,0.66605,0.62,0.190925,935,6105,7040,7040,0.7283333333333334,0.62,0.190925
607,2012-08-29,3,1,8,0,3,1,1,0.685,0.635733,0.552083,0.112562,1177,6520,7697,7697,0.685,0.5520833333333334,0.11256250000000001
608,2012-08-30,3,1,8,0,4,1,1,0.706667,0.652779,0.590417,0.0771167,1172,6541,7713,7713,0.7066666666666667,0.5904166666666667,0.07711666666666667
609,2012-08-31,3,1,8,0,5,1,1,0.764167,0.6894,0.5875,0.168533,1433,5917,7350,7350,0.7641666666666667,0.5875,0.16853333333333334
610,2012-09-01,3,1,9,0,6,0,2,0.753333,0.702654,0.638333,0.113187,2352,3788,6140,6140,0.7533333333333333,0.6383333333333333,0.1131875
611,2012-09-02,3,1,9,0,0,0,2,0.696667,0.649,0.815,0.0640708,2613,3197,5810,5810,0.6966666666666667,0.815,0.06407083333333334
612,2012-09-03,3,1,9,1,1,0,1,0.7075,0.661629,0.790833,0.151121,1965,4069,6034,6034,0.7075,0.7908333333333334,0.15112083333333334
613,2012-09-04,3,1,9,0,2,1,1,0.725833,0.686888,0.755,0.236321,867,5997,6864,6864,0.7258333333333334,0.755,0.2363208333333333
614,2012-09-05,3,1,9,0,3,1,1,0.736667,0.708983,0.74125,0.187808,832,6280,7112,7112,0.7366666666666667,0.74125,0.18780833333333333
615,2012-09-06,3,1,9,0,4,1,2,0.696667,0.655329,0.810417,0.142421,611,5592,6203,6203,0.6966666666666667,0.8104166666666667,0.14242083333333333
616,2012-09-07,3,1,9,0,5,1,1,0.703333,0.657204,0.73625,0.171646,1045,6459,7504,7504,0.7033333333333333,0.7362500000000001,0.17164583333333336
617,2012-09-08,3,1,9,0,6,0,2,0.659167,0.611121,0.799167,0.281104,1557,4419,5976,5976,0.6591666666666667,0.7991666666666667,0.28110416666666665
618,2012-09-09,3,1,9,0,0,0,1,0.61,0.578925,0.5475,0.224496,2570,5657,8227,8227,0.61,0.5475,0.22449583333333334
619,2012-09-10,3,1,9,0,1,1,1,0.583333,0.565654,0.50375,0.258713,1118,6407,7525,7525,0.5833333333333334,0.50375,0.2587125
620,2012-09-11,3,1,9,0,2,1,1,0.5775,0.554292,0.52,0.0920542,1070,6697,7767,7767,0.5775,0.52,0.09205416666666666
621,2012-09-12,3,1,9,0,3,1,1,0.599167,0.570075,0.577083,0.131846,1050,6820,7870,7870,0.5991666666666667,0.5770833333333333,0.13184583333333333
622,2012-09-13,3,1,9,0,4,1,1,0.6125,0.579558,0.637083,0.0827208,1054,6750,7804,7804,0.6124999999999999,0.6370833333333333,0.08272083333333334
623,2012-09-14,3,1,9,0,5,1,1,0.633333,0.594083,0.6725,0.103863,1379,6630,8009,8009,0.6333333333333334,0.6725,0.10386250000000001
624,2012-09-15,3,1,9,0,6,0,1,0.608333,0.585867,0.501667,0.247521,3160,5554,8714,8714,0.6083333333333333,0.5016666666666666,0.24752083333333333
625,2012-09-16,3,1,9,0,0,0,1,0.58,0.563125,0.57,0.0901833,2166,5167,7333,7333,0.58,0.57,0.09018333333333334
626,2012-09-17,3,1,9,0,1,1,2,0.580833,0.55305,0.734583,0.151742,1022,5847,6869,6869,0.5808333333333333,0.7345833333333333,0.15174166666666666
627,2012-09-18,3,1,9,0,2,1,2,0.623333,0.565067,0.8725,0.357587,371,3702,4073,4073,0.6233333333333334,0.8725,0.3575875
628,2012-09-19,3,1,9,0,3,1,1,0.5525,0.540404,0.536667,0.215175,788,6803,7591,7591,0.5525,0.5366666666666667,0.215175
629,2012-09-20,3,1,9,0,4,1,1,0.546667,0.532192,0.618333,0.118167,939,6781,7720,7720,0.5466666666666667,0.6183333333333333,0.11816666666666666
630,2012-09-21,3,1,9,0,5,1,1,0.599167,0.571971,0.66875,0.154229,1250,6917,8167,8167,0.5991666666666667,0.6687500000000001,0.15422916666666667
631,2012-09-22,3,1,9,0,6,0,1,0.65,0.610488,0.646667,0.283583,2512,5883,8395,8395,0.65,0.6466666666666666,0.28358333333333335
632,2012-09-23,4,1,9,0,0,0,1,0.529167,0.518933,0.467083,0.223258,2454,5453,7907,7907,0.5291666666666667,0.46708333333333335,0.22325833333333334
633,2012-09-24,4,1,9,0,1,1,1,0.514167,0.502513,0.492917,0.142404,1001,6435,7436,7436,0.5141666666666667,0.49291666666666667,0.14240416666666667
634,2012-09-25,4,1,9,0,2,1,1,0.55,0.544179,0.57,0.236321,845,6693,7538,7538,0.5499999999999999,0.57,0.23632083333333334
635,2012-09-26,4,1,9,0,3,1,1,0.635,0.596613,0.630833,0.2444,787,6946,7733,7733,0.635,0.6308333333333334,0.24439999999999998
636,2012-09-27,4,1,9,0,4,1,2,0.65,0.607975,0.690833,0.134342,751,6642,7393,7393,0.65,0.6908333333333333,0.13434166666666666
637,2012-09-28,4,1,9,0,5,1,2,0.619167,0.585863,0.69,0.164179,1045,6370,7415,7415,0.6191666666666666,0.69,0.16417916666666665
638,2012-09-29,4,1,9,0,6,0,1,0.5425,0.530296,0.542917,0.227604,2589,5966,8555,8555,0.5425,0.5429166666666667,0.2276041666666667
639,2012-09-30,4,1,9,0,0,0,1,0.526667,0.517663,0.583333,0.134958,2015,4874,6889,6889,0.5266666666666667,0.5833333333333334,0.13495833333333332
640,2012-10-01,4,1,10,0,1,1,2,0.520833,0.512,0.649167,0.0908042,763,6015,6778,6778,0.5208333333333334,0.6491666666666667,0.09080416666666667
641,2012-10-02,4,1,10,0,2,1,3,0.590833,0.542333,0.871667,0.104475,315,4324,4639,4639,0.5908333333333333,0.8716666666666666,0.104475
642,2012-10-03,4,1,10,0,3,1,2,0.6575,0.599133,0.79375,0.0665458,728,6844,7572,7572,0.6575,0.7937500000000001,0.06654583333333333
643,2012-10-04,4,1,10,0,4,1,2,0.6575,0.607975,0.722917,0.117546,891,6437,7328,7328,0.6575,0.7229166666666668,0.11754583333333334
644,2012-10-05,4,1,10,0,5,1,1,0.615,0.580187,0.6275,0.10635,1516,6640,8156,8156,0.615,0.6275000000000001,0.10635
645,2012-10-06,4,1,10,0,6,0,1,0.554167,0.538521,0.664167,0.268025,3031,4934,7965,7965,0.5541666666666667,0.6641666666666667,0.268025
646,2012-10-07,4,1,10,0,0,0,2,0.415833,0.419813,0.708333,0.141162,781,2729,3510,3510,0.41583333333333333,0.7083333333333334,0.1411625
647,2012-10-08,4,1,10,1,1,0,2,0.383333,0.387608,0.709583,0.189679,874,4604,5478,5478,0.3833333333333333,0.7095833333333333,0.18967916666666665
648,2012-10-09,4,1,10,0,2,1,2,0.446667,0.438112,0.761667,0.1903,601,5791,6392,6392,0.4466666666666667,0.7616666666666667,0.1903
649,2012-10-10,4,1,10,0,3,1,1,0.514167,0.503142,0.630833,0.187821,780,6911,7691,7691,0.5141666666666667,0.6308333333333334,0.18782083333333333
650,2012-10-11,4,1,10,0,4,1,1,0.435,0.431167,0.463333,0.181596,834,6736,7570,7570,0.435,0.4633333333333333,0.18159583333333332
651,2012-10-12,4,1,10,0,5,1,1,0.4375,0.433071,0.539167,0.235092,1060,6222,7282,7282,0.4375,0.5391666666666667,0.23509166666666667
652,2012-10-13,4,1,10,0,6,0,1,0.393333,0.391396,0.494583,0.146142,2252,4857,7109,7109,0.3933333333333333,0.4945833333333333,0.14614166666666667
653,2012-10-14,4,1,10,0,0,0,1,0.521667,0.508204,0.640417,0.278612,2080,4559,6639,6639,0.5216666666666666,0.6404166666666666,0.2786125
654,2012-10-15,4,1,10,0,1,1,2,0.561667,0.53915,0.7075,0.296037,760,5115,5875,5875,0.5616666666666666,0.7075,0.2960375
655,2012-10-16,4,1,10,0,2,1,1,0.468333,0.460846,0.558333,0.182221,922,6612,7534,7534,0.4683333333333333,0.5583333333333333,0.18222083333333336
656,2012-10-17,4,1,10,0,3,1,1,0.455833,0.450108,0.692917,0.101371,979,6482,7461,7461,0.4558333333333333,0.6929166666666666,0.10137083333333334
657,2012-10-18,4,1,10,0,4,1,2,0.5225,0.512625,0.728333,0.236937,1008,6501,7509,7509,0.5225000000000001,0.7283333333333334,0.2369375
658,2012-10-19,4,1,10,0,5,1,2,0.563333,0.537896,0.815,0.134954,753,4671,5424,5424,0.5633333333333334,0.815,0.13495416666666668
659,2012-10-20,4,1,10,0,6,0,1,0.484167,0.472842,0.572917,0.117537,2806,5284,8090,8090,0.4841666666666667,0.5729166666666666,0.1175375
660,2012-10-21,4,1,10,0,0,0,1,0.464167,0.456429,0.51,0.166054,2132,4692,6824,6824,0.46416666666666667,0.51,0.16605416666666667
661,2012-10-22,4,1,10,0,1,1,1,0.4875,0.482942,0.568333,0.0814833,830,6228,7058,7058,0.4875,0.5683333333333334,0.08148333333333334
662,2012-10-23,4,1,10,0,2,1,1,0.544167,0.530304,0.641667,0.0945458,841,6625,7466,7466,0.5441666666666667,0.6416666666666667,0.09454583333333333
663,2012-10-24,4,1,10,0,3,1,1,0.5875,0.558721,0.63625,0.0727792,795,6898,7693,7693,0.5875,0.63625,0.07277916666666666
664,2012-10-25,4,1,10,0,4,1,2,0.55,0.529688,0.800417,0.124375,875,6484,7359,7359,0.55,0.8004166666666667,0.124375
665,2012-10-26,4,1,10,0,5,1,2,0.545833,0.52275,0.807083,0.132467,1182,6262,7444,7444,0.5458333333333333,0.8070833333333334,0.13246666666666668
666,2012-10-27,4,1,10,0,6,0,2,0.53,0.515133,0.72,0.235692,2643,5209,7852,7852,0.53,0.7200000000000001,0.23569166666666666
667,2012-10-28,4,1,10,0,0,0,2,0.4775,0.467771,0.694583,0.398008,998,3461,4459,4459,0.4775,0.6945833333333332,0.39800833333333335
668,2012-10-29,4,1,10,0,1,1,3,0.44,0.4394,0.88,0.3582,2,20,22,22,0.44,0.88,0.3582
669,2012-10-30,4,1,10,0,2,1,2,0.318182,0.309909,0.825455,0.213009,87,1009,1096,1096,0.3181818181818182,0.8254545454545454,0.21300909090909093
670,2012-10-31,4,1,10,0,3,1,2,0.3575,0.3611,0.666667,0.166667,419,5147,5566,5566,0.3575,0.6666666666666666,0.16666666666666666
671,2012-11-01,4,1,11,0,4,1,2,0.365833,0.369942,0.581667,0.157346,466,5520,5986,5986,0.3658333333333333,0.5816666666666667,0.15734583333333332
672,2012-11-02,4,1,11,0,5,1,1,0.355,0.356042,0.522083,0.266175,618,5229,5847,5847,0.355,0.5220833333333333,0.266175
673,2012-11-03,4,1,11,0,6,0,2,0.343333,0.323846,0.49125,0.270529,1029,4109,5138,5138,0.3433333333333333,0.49124999999999996,0.27052916666666665
674,2012-11-04,4,1,11,0,0,0,1,0.325833,0.329538,0.532917,0.179108,1201,3906,5107,5107,0.32583333333333336,0.5329166666666667,0.17910833333333334
675,2012-11-05,4,1,11,0,1,1,1,0.319167,0.308075,0.494167,0.236325,378,4881,5259,5259,0.31916666666666665,0.4941666666666667,0.236325
676,2012-11-06,4,1,11,0,2,1,1,0.280833,0.281567,0.567083,0.173513,466,5220,5686,5686,0.2808333333333333,0.5670833333333333,0.1735125
677,2012-11-07,4,1,11,0,3,1,2,0.295833,0.274621,0.5475,0.304108,326,4709,5035,5035,0.29583333333333334,0.5475,0.30410833333333337
678,2012-11-08,4,1,11,0,4,1,1,0.352174,0.341891,0.333478,0.347835,340,4975,5315,5315,0.3521739130434782,0.3334782608695652,0.34783478260869566
679,2012-11-09,4,1,11,0,5,1,1,0.361667,0.355413,0.540833,0.214558,709,5283,5992,5992,0.36166666666666664,0.5408333333333334,0.21455833333333332
680,2012-11-10,4,1,11,0,6,0,1,0.389167,0.393937,0.645417,0.0578458,2090,4446,6536,6536,0.38916666666666666,0.6454166666666666,0.05784583333333334
681,2012-11-11,4,1,11,0,0,0,1,0.420833,0.421713,0.659167,0.1275,2290,4562,6852,6852,0.42083333333333334,0.6591666666666667,0.1275
682,2012-11-12,4,1,11,1,1,0,1,0.485,0.475383,0.741667,0.173517,1097,5172,6269,6269,0.48500000000000004,0.7416666666666667,0.17351666666666665
683,2012-11-13,4,1,11,0,2,1,2,0.343333,0.323225,0.662917,0.342046,327,3767,4094,4094,0.3433333333333333,0.6629166666666667,0.3420458333333333
684,2012-11-14,4,1,11,0,3,1,1,0.289167,0.281563,0.552083,0.199625,373,5122,5495,5495,0.2891666666666667,0.5520833333333334,0.19962500000000002
685,2012-11-15,4,1,11,0,4,1,2,0.321667,0.324492,0.620417,0.152987,320,5125,5445,5445,0.32166666666666666,0.6204166666666667,0.1529875
686,2012-11-16,4,1,11,0,5,1,1,0.345,0.347204,0.524583,0.171025,484,5214,5698,5698,0.345,0.5245833333333333,0.17102499999999998
687,2012-11-17,4,1,11,0,6,0,1,0.325,0.326383,0.545417,0.179729,1313,4316,5629,5629,0.325,0.5454166666666667,0.1797291666666667
688,2012-11-18,4,1,11,0,0,0,1,0.3425,0.337746,0.692917,0.227612,922,3747,4669,4669,0.3425,0.6929166666666666,0.2276125
689,2012-11-19,4,1,11,0,1,1,2,0.380833,0.375621,0.623333,0.235067,449,5050,5499,5499,0.38083333333333336,0.6233333333333334,0.23506666666666665
690,2012-11-20,4,1,11,0,2,1,2,0.374167,0.380667,0.685,0.082725,534,5100,5634,5634,0.3741666666666667,0.685,0.082725
691,2012-11-21,4,1,11,0,3,1,1,0.353333,0.364892,0.61375,0.103246,615,4531,5146,5146,0.35333333333333333,0.61375,0.10324583333333333
692,2012-11-22,4,1,11,1,4,0,1,0.34,0.350371,0.580417,0.0528708,955,1470,2425,2425,0.34,0.5804166666666667,0.05287083333333333
693,2012-11-23,4,1,11,0,5,1,1,0.368333,0.378779,0.56875,0.148021,1603,2307,3910,3910,0.36833333333333335,0.56875,0.14802083333333335
694,2012-11-24,4,1,11,0,6,0,1,0.278333,0.248742,0.404583,0.376871,532,1745,2277,2277,0.2783333333333333,0.4045833333333333,0.3768708333333333
695,2012-11-25,4,1,11,0,0,0,1,0.245833,0.257583,0.468333,0.1505,309,2115,2424,2424,0.24583333333333335,0.4683333333333333,0.1505
696,2012-11-26,4,1,11,0,1,1,1,0.313333,0.339004,0.535417,0.04665,337,4750,5087,5087,0.31333333333333335,0.5354166666666667,0.04665
697,2012-11-27,4,1,11,0,2,1,2,0.291667,0.281558,0.786667,0.237562,123,3836,3959,3959,0.2916666666666667,0.7866666666666666,0.2375625
698,2012-11-28,4,1,11,0,3,1,1,0.296667,0.289762,0.50625,0.210821,198,5062,5260,5260,0.2966666666666667,0.50625,0.21082083333333335
699,2012-11-29,4,1,11,0,4,1,1,0.28087,0.298422,0.555652,0.115522,243,5080,5323,5323,0.2808695652173913,0.5556521739130434,0.11552173913043479
700,2012-11-30,4,1,11,0,5,1,1,0.298333,0.323867,0.649583,0.0584708,362,5306,5668,5668,0.29833333333333334,0.6495833333333333,0.05847083333333333
701,2012-12-01,4,1,12,0,6,0,2,0.298333,0.316904,0.806667,0.0597042,951,4240,5191,5191,0.29833333333333334,0.8066666666666666,0.05970416666666667
702,2012-12-02,4,1,12,0,0,0,2,0.3475,0.359208,0.823333,0.124379,892,3757,4649,4649,0.3475,0.8233333333333334,0.12437916666666667
703,2012-12-03,4,1,12,0,1,1,1,0.4525,0.455796,0.7675,0.0827208,555,5679,6234,6234,0.45249999999999996,0.7675000000000001,0.08272083333333334
704,2012-12-04,4,1,12,0,2,1,1,0.475833,0.469054,0.73375,0.174129,551,6055,6606,6606,0.47583333333333333,0.73375,0.17412916666666667
705,2012-12-05,4,1,12,0,3,1,1,0.438333,0.428012,0.485,0.324021,331,5398,5729,5729,0.4383333333333333,0.48500000000000004,0.32402083333333337
706,2012-12-06,4,1,12,0,4,1,1,0.255833,0.258204,0.50875,0.174754,340,5035,5375,5375,0.2558333333333333,0.50875,0.17475416666666665
707,2012-12-07,4,1,12,0,5,1,2,0.320833,0.321958,0.764167,0.1306,349,4659,5008,5008,0.32083333333333336,0.7641666666666667,0.1306
708,2012-12-08,4,1,12,0,6,0,2,0.381667,0.389508,0.91125,0.101379,1153,4429,5582,5582,0.38166666666666665,0.91125,0.10137916666666667
709,2012-12-09,4,1,12,0,0,0,2,0.384167,0.390146,0.905417,0.157975,441,2787,3228,3228,0.3841666666666667,0.9054166666666666,0.157975
710,2012-12-10,4,1,12,0,1,1,2,0.435833,0.435575,0.925,0.190308,329,4841,5170,5170,0.43583333333333335,0.9249999999999999,0.19030833333333333
711,2012-12-11,4,1,12,0,2,1,2,0.353333,0.338363,0.596667,0.296037,282,5219,5501,5501,0.35333333333333333,0.5966666666666667,0.2960375
712,2012-12-12,4,1,12,0,3,1,2,0.2975,0.297338,0.538333,0.162937,310,5009,5319,5319,0.29750000000000004,0.5383333333333333,0.16293749999999999
713,2012-12-13,4,1,12,0,4,1,1,0.295833,0.294188,0.485833,0.174129,425,5107,5532,5532,0.29583333333333334,0.48583333333333334,0.17412916666666667
714,2012-12-14,4,1,12,0,5,1,1,0.281667,0.294192,0.642917,0.131229,429,5182,5611,5611,0.2816666666666667,0.6429166666666667,0.13122916666666667
715,2012-12-15,4,1,12,0,6,0,1,0.324167,0.338383,0.650417,0.10635,767,4280,5047,5047,0.32416666666666666,0.6504166666666666,0.10635
716,2012-12-16,4,1,12,0,0,0,2,0.3625,0.369938,0.83875,0.100742,538,3248,3786,3786,0.3625,0.83875,0.10074166666666667
717,2012-12-17,4,1,12,0,1,1,2,0.393333,0.4015,0.907083,0.0982583,212,4373,4585,4585,0.3933333333333333,0.9070833333333334,0.09825833333333334
718,2012-12-18,4,1,12,0,2,1,1,0.410833,0.409708,0.66625,0.221404,433,5124,5557,5557,0.41083333333333333,0.66625,0.22140416666666665
719,2012-12-19,4,1,12,0,3,1,1,0.3325,0.342162,0.625417,0.184092,333,4934,5267,5267,0.3325,0.6254166666666666,0.18409166666666665
720,2012-12-20,4,1,12,0,4,1,2,0.33,0.335217,0.667917,0.132463,314,3814,4128,4128,0.33,0.6679166666666667,0.1324625
721,2012-12-21,1,1,12,0,5,1,2,0.326667,0.301767,0.556667,0.374383,221,3402,3623,3623,0.32666666666666666,0.5566666666666666,0.37438333333333335
722,2012-12-22,1,1,12,0,6,0,1,0.265833,0.236113,0.44125,0.407346,205,1544,1749,1749,0.2658333333333333,0.44125,0.4073458333333333
723,2012-12-23,1,1,12,0,0,0,1,0.245833,0.259471,0.515417,0.133083,408,1379,1787,1787,0.24583333333333335,0.5154166666666666,0.13308333333333333
724,2012-12-24,1,1,12,0,1,1,2,0.231304,0.2589,0.791304,0.0772304,174,746,920,920,0.23130434782608697,0.7913043478260869,0.0772304347826087
725,2012-12-25,1,1,12,1,2,0,2,0.291304,0.294465,0.734783,0.168726,440,573,1013,1013,0.29130434782608694,0.7347826086956522,0.16872608695652175
726,2012-12-26,1,1,12,0,3,1,3,0.243333,0.220333,0.823333,0.316546,9,432,441,441,0.24333333333333332,0.8233333333333334,0.31654583333333336
727,2012-12-27,1,1,12,0,4,1,2,0.254167,0.226642,0.652917,0.350133,247,1867,2114,2114,0.25416666666666665,0.6529166666666667,0.35013333333333335
728,2012-12-28,1,1,12,0,5,1,2,0.253333,0.255046,0.59,0.155471,644,2451,3095,3095,0.25333333333333335,0.59,0.15547083333333334
729,2012-12-29,1,1,12,0,6,0,2,0.253333,0.2424,0.752917,0.124383,159,1182,1341,1341,0.25333333333333335,0.7529166666666667,0.12438333333333333
730,2012-12-30,1,1,12,0,0,0,1,0.255833,0.2317,0.483333,0.350754,364,1432,1796,1796,0.25583333333333336,0.48333333333333334,0.35075416666666664
731,2012-12-31,1,1,12,0,1,1,2,0.215833,0.223487,0.5775,0.154846,439,2290,2729,2729,0.21583333333333332,0.5775,0.15484583333333332
